tanggal,kecamatan,odp,proses_pemantauan,selesai_pemantauan,pdp,masih_dirawat,pulang_dan_sehat,positif,dirawat,sembuh,meninggal,isolasi_mandiri
2020-05-01,BELUM DIKETAHUI,2656,49,2607,2752,150,2602,411,340,13,6,52
2020-05-01,CAKUNG,161,3,158,64,27,37,80,37,10,9,24
2020-05-01,CEMPAKA PUTIH,177,2,175,61,13,48,75,33,5,7,30
2020-05-01,CENGKARENG,58,2,56,30,7,23,75,39,7,8,21
2020-05-01,CILANDAK,89,5,84,63,13,50,76,31,12,14,19
2020-05-01,CILINCING,205,4,201,43,20,23,44,23,0,5,16
2020-05-01,CIPAYUNG,77,5,72,39,20,19,39,23,5,1,10
2020-05-01,CIRACAS,108,3,105,42,14,28,42,19,4,5,14
2020-05-01,DUREN SAWIT,101,1,100,44,26,18,141,69,12,23,37
2020-05-01,GAMBIR,90,5,85,30,17,13,34,13,3,6,12
2020-05-01,GROGOL PETAMBURAN,102,2,100,39,13,26,99,41,27,11,20
2020-05-01,JAGAKARSA,65,0,65,45,10,35,69,31,7,5,26
2020-05-01,JATINEGARA,48,4,44,26,10,16,75,39,1,9,26
2020-05-01,JOHAR BARU,114,1,113,35,15,20,40,12,6,7,15
2020-05-01,KALI DERES,67,2,65,44,12,32,96,35,23,9,29
2020-05-01,KEBAYORAN BARU,60,4,56,54,31,23,58,21,26,3,8
2020-05-01,KEBAYORAN LAMA,70,2,68,42,21,21,92,39,12,15,26
2020-05-01,KEBON JERUK,125,2,123,61,20,41,118,53,18,11,36
2020-05-01,KELAPA GADING,208,1,207,77,20,57,89,34,16,7,32
2020-05-01,KEMAYORAN,170,8,162,74,36,38,73,22,5,12,34
2020-05-01,KEMBANGAN,51,3,48,39,17,22,75,30,16,4,25
2020-05-01,KEP. SERIBU SELATAN,37,1,36,4,0,4,9,0,0,0,9
2020-05-01,KEP. SERIBU UTARA,102,2,100,12,1,11,1,0,0,0,1
2020-05-01,KOJA,145,8,137,58,21,37,58,27,3,2,26
2020-05-01,KRAMAT JATI,57,2,55,33,15,18,74,25,5,8,36
2020-05-01,LUAR DKI JAKARTA,1340,24,1316,911,120,791,776,434,65,54,223
2020-05-01,MAKASAR,37,2,35,23,5,18,49,24,9,7,9
2020-05-01,MAMPANG PRAPATAN,93,1,92,26,12,14,38,14,6,6,12
2020-05-01,MATRAMAN,139,7,132,65,23,42,79,37,4,8,30
2020-05-01,MENTENG,57,0,57,24,10,14,53,25,6,8,14
2020-05-01,PADEMANGAN,100,4,96,30,9,21,74,24,4,6,40
2020-05-01,PALMERAH,73,3,70,35,16,19,73,33,9,6,25
2020-05-01,PANCORAN,43,1,42,27,8,19,43,26,5,3,9
2020-05-01,PASAR MINGGU,152,5,147,53,18,35,82,37,11,12,22
2020-05-01,PASAR REBO,35,6,29,25,10,15,34,13,4,4,13
2020-05-01,PENJARINGAN,104,3,101,52,9,43,70,40,5,7,18
2020-05-01,PESANGGRAHAN,43,1,42,31,9,22,64,26,10,14,14
2020-05-01,PULO GADUNG,143,6,137,72,30,42,95,51,8,9,27
2020-05-01,SAWAH BESAR,126,7,119,53,18,35,55,34,3,6,12
2020-05-01,SENEN,108,2,106,43,21,22,58,24,4,3,27
2020-05-01,SETIA BUDI,67,1,66,37,7,30,49,24,9,8,8
2020-05-01,TAMAN SARI,60,1,59,31,13,18,65,49,0,4,12
2020-05-01,TAMBORA,38,2,36,22,13,9,31,19,2,4,6
2020-05-01,TANAH ABANG,179,7,172,83,35,48,213,64,6,11,132
2020-05-01,TANJUNG PRIOK,174,12,162,104,47,57,144,76,8,15,45
2020-05-01,TEBET,57,1,56,46,15,31,95,41,13,11,30
2020-05-02,BELUM DIKETAHUI,2654,49,2605,2685,149,2536,354,276,46,7,25
2020-05-02,CAKUNG,162,3,159,67,27,40,83,38,12,9,24
2020-05-02,CEMPAKA PUTIH,176,2,174,62,14,48,77,34,6,7,30
2020-05-02,CENGKARENG,60,2,58,36,7,29,76,40,7,8,21
2020-05-02,CILANDAK,89,5,84,76,13,63,77,30,13,14,20
2020-05-02,CILINCING,216,4,212,49,21,28,46,25,0,5,16
2020-05-02,CIPAYUNG,78,5,73,55,20,35,39,22,6,1,10
2020-05-02,CIRACAS,109,3,106,48,14,34,45,17,9,5,14
2020-05-02,DUREN SAWIT,101,1,100,65,26,39,142,67,16,23,36
2020-05-02,GAMBIR,87,5,82,32,14,18,35,14,3,6,12
2020-05-02,GROGOL PETAMBURAN,102,2,100,41,13,28,101,41,29,11,20
2020-05-02,JAGAKARSA,66,0,66,53,10,43,69,31,7,5,26
2020-05-02,JATINEGARA,48,4,44,32,9,23,79,41,3,9,26
2020-05-02,JOHAR BARU,114,1,113,38,17,21,40,12,6,7,15
2020-05-02,KALI DERES,68,2,66,52,12,40,96,35,24,9,28
2020-05-02,KEBAYORAN BARU,60,4,56,61,31,30,58,21,26,3,8
2020-05-02,KEBAYORAN LAMA,70,2,68,53,21,32,92,39,12,15,26
2020-05-02,KEBON JERUK,134,2,132,65,20,45,125,54,21,11,39
2020-05-02,KELAPA GADING,209,1,208,80,21,59,97,39,17,7,34
2020-05-02,KEMAYORAN,168,8,160,81,32,49,76,19,9,12,36
2020-05-02,KEMBANGAN,51,3,48,42,17,25,78,31,18,4,25
2020-05-02,KEP. SERIBU SELATAN,37,1,36,5,0,5,9,0,0,0,9
2020-05-02,KEP. SERIBU UTARA,102,2,100,12,1,11,1,0,0,0,1
2020-05-02,KOJA,148,10,138,63,21,42,61,28,4,2,27
2020-05-02,KRAMAT JATI,57,2,55,39,15,24,76,25,7,8,36
2020-05-02,LUAR DKI JAKARTA,1285,24,1261,885,122,763,803,429,89,57,228
2020-05-02,MAKASAR,37,2,35,28,5,23,50,24,9,7,10
2020-05-02,MAMPANG PRAPATAN,93,1,92,30,12,18,40,15,7,6,12
2020-05-02,MATRAMAN,141,7,134,75,23,52,83,37,7,8,31
2020-05-02,MENTENG,57,0,57,26,12,14,55,25,6,8,16
2020-05-02,PADEMANGAN,117,4,113,39,9,30,77,25,5,6,41
2020-05-02,PALMERAH,74,3,71,39,16,23,78,32,14,6,26
2020-05-02,PANCORAN,43,1,42,32,8,24,46,27,6,3,10
2020-05-02,PASAR MINGGU,155,5,150,57,18,39,88,43,11,12,22
2020-05-02,PASAR REBO,34,6,28,27,10,17,36,13,5,4,14
2020-05-02,PENJARINGAN,104,3,101,58,9,49,72,41,6,7,18
2020-05-02,PESANGGRAHAN,43,1,42,38,9,29,65,26,11,14,14
2020-05-02,PULO GADUNG,147,6,141,78,30,48,98,50,12,10,26
2020-05-02,SAWAH BESAR,123,6,117,55,19,36,58,36,4,6,12
2020-05-02,SENEN,112,1,111,46,19,27,60,23,7,3,27
2020-05-02,SETIA BUDI,67,1,66,37,7,30,52,26,10,8,8
2020-05-02,TAMAN SARI,60,1,59,34,13,21,66,35,14,4,13
2020-05-02,TAMBORA,38,2,36,24,13,11,32,19,4,4,5
2020-05-02,TANAH ABANG,190,7,183,104,33,71,214,64,7,11,132
2020-05-02,TANJUNG PRIOK,174,12,162,132,47,85,149,77,10,17,45
2020-05-02,TEBET,57,1,56,58,15,43,101,43,17,11,30
2020-05-03,BELUM DIKETAHUI,2632,49,2583,2492,145,2347,309,239,43,6,21
2020-05-03,CAKUNG,163,3,160,76,27,49,85,39,13,9,24
2020-05-03,CEMPAKA PUTIH,176,2,174,68,14,54,78,35,7,7,29
2020-05-03,CENGKARENG,62,1,61,55,7,48,82,44,9,8,21
2020-05-03,CILANDAK,90,5,85,83,15,68,78,31,14,14,19
2020-05-03,CILINCING,216,4,212,49,21,28,48,25,1,5,17
2020-05-03,CIPAYUNG,80,5,75,58,21,37,41,22,6,1,12
2020-05-03,CIRACAS,109,3,106,52,14,38,46,17,9,6,14
2020-05-03,DUREN SAWIT,104,1,103,80,26,54,148,66,19,24,39
2020-05-03,GAMBIR,87,5,82,36,14,22,35,14,4,6,11
2020-05-03,GROGOL PETAMBURAN,103,2,101,71,13,58,107,42,31,12,22
2020-05-03,JAGAKARSA,66,0,66,55,10,45,71,31,9,5,26
2020-05-03,JATINEGARA,49,4,45,36,9,27,81,42,6,9,24
2020-05-03,JOHAR BARU,113,1,112,39,17,22,41,12,7,7,15
2020-05-03,KALI DERES,70,2,68,103,13,90,97,33,29,9,26
2020-05-03,KEBAYORAN BARU,61,4,57,69,32,37,58,21,27,3,7
2020-05-03,KEBAYORAN LAMA,71,2,69,76,21,55,96,40,14,16,26
2020-05-03,KEBON JERUK,138,2,136,109,20,89,126,56,25,11,34
2020-05-03,KELAPA GADING,208,1,207,93,20,73,100,40,18,7,35
2020-05-03,KEMAYORAN,167,7,160,81,33,48,76,19,8,12,37
2020-05-03,KEMBANGAN,52,3,49,72,17,55,81,32,18,5,26
2020-05-03,KEP. SERIBU SELATAN,37,1,36,5,0,5,9,0,0,0,9
2020-05-03,KEP. SERIBU UTARA,102,2,100,12,1,11,1,0,0,0,1
2020-05-03,KOJA,148,10,138,65,21,44,62,28,4,2,28
2020-05-03,KRAMAT JATI,57,2,55,40,15,25,80,29,7,8,36
2020-05-03,LUAR DKI JAKARTA,1283,23,1260,898,124,774,817,425,105,59,228
2020-05-03,MAKASAR,38,2,36,30,5,25,51,25,9,7,10
2020-05-03,MAMPANG PRAPATAN,93,1,92,31,12,19,42,16,7,6,13
2020-05-03,MATRAMAN,144,7,137,79,23,56,87,35,10,9,33
2020-05-03,MENTENG,57,0,57,29,13,16,55,25,6,8,16
2020-05-03,PADEMANGAN,116,4,112,45,9,36,79,26,5,6,42
2020-05-03,PALMERAH,78,3,75,90,16,74,79,31,15,7,26
2020-05-03,PANCORAN,43,1,42,34,8,26,47,26,7,3,11
2020-05-03,PASAR MINGGU,156,5,151,60,18,42,90,45,11,12,22
2020-05-03,PASAR REBO,34,6,28,28,10,18,35,11,6,4,14
2020-05-03,PENJARINGAN,104,3,101,63,9,54,72,41,6,7,18
2020-05-03,PESANGGRAHAN,44,1,43,43,9,34,65,25,12,14,14
2020-05-03,PULO GADUNG,147,6,141,85,33,52,101,51,14,10,26
2020-05-03,SAWAH BESAR,123,6,117,57,19,38,63,39,5,6,13
2020-05-03,SENEN,112,1,111,47,19,28,60,22,9,4,25
2020-05-03,SETIA BUDI,67,1,66,43,7,36,54,26,13,8,7
2020-05-03,TAMAN SARI,61,1,60,37,13,24,68,34,14,5,15
2020-05-03,TAMBORA,40,2,38,41,13,28,33,20,4,4,5
2020-05-03,TANAH ABANG,190,7,183,137,33,104,225,62,8,11,144
2020-05-03,TANJUNG PRIOK,176,12,164,141,47,94,157,77,11,17,52
2020-05-03,TEBET,57,1,56,65,15,50,101,43,17,11,30
2020-05-04,BELUM DIKETAHUI,2673,49,2624,2494,145,2349,263,194,43,5,21
2020-05-04,CAKUNG,182,4,178,78,28,50,90,42,13,9,26
2020-05-04,CEMPAKA PUTIH,232,4,228,111,15,96,78,35,7,7,29
2020-05-04,CENGKARENG,65,1,64,55,7,48,83,45,9,8,21
2020-05-04,CILANDAK,92,5,87,84,15,69,78,31,14,14,19
2020-05-04,CILINCING,244,5,239,51,21,30,47,24,1,5,17
2020-05-04,CIPAYUNG,83,5,78,59,22,37,44,24,6,1,13
2020-05-04,CIRACAS,130,4,126,53,14,39,45,17,8,6,14
2020-05-04,DUREN SAWIT,117,1,116,89,28,61,153,70,21,24,38
2020-05-04,GAMBIR,90,5,85,37,14,23,34,14,3,6,11
2020-05-04,GROGOL PETAMBURAN,135,4,131,72,13,59,115,48,36,11,20
2020-05-04,JAGAKARSA,79,0,79,55,10,45,72,30,11,5,26
2020-05-04,JATINEGARA,53,4,49,36,9,27,83,44,6,9,24
2020-05-04,JOHAR BARU,113,1,112,39,17,22,41,12,7,7,15
2020-05-04,KALI DERES,78,2,76,109,13,96,99,35,29,9,26
2020-05-04,KEBAYORAN BARU,65,4,61,69,32,37,58,21,27,3,7
2020-05-04,KEBAYORAN LAMA,73,2,71,76,21,55,102,46,14,16,26
2020-05-04,KEBON JERUK,152,2,150,111,20,91,128,57,26,11,34
2020-05-04,KELAPA GADING,238,1,237,98,21,77,100,40,18,7,35
2020-05-04,KEMAYORAN,170,8,162,82,33,49,79,22,8,12,37
2020-05-04,KEMBANGAN,53,3,50,72,17,55,83,34,18,5,26
2020-05-04,KEP. SERIBU SELATAN,38,1,37,5,0,5,9,0,0,0,9
2020-05-04,KEP. SERIBU UTARA,109,2,107,14,2,12,1,0,0,0,1
2020-05-04,KOJA,161,10,151,67,22,45,64,30,4,2,28
2020-05-04,KRAMAT JATI,63,3,60,40,15,25,84,33,6,9,36
2020-05-04,LUAR DKI JAKARTA,1315,24,1291,900,126,774,841,436,116,60,229
2020-05-04,MAKASAR,41,2,39,31,5,26,53,26,10,7,10
2020-05-04,MAMPANG PRAPATAN,141,1,140,31,12,19,43,17,7,6,13
2020-05-04,MATRAMAN,147,7,140,80,23,57,87,35,10,9,33
2020-05-04,MENTENG,58,1,57,31,13,18,58,27,7,8,16
2020-05-04,PADEMANGAN,139,4,135,53,9,44,81,27,5,6,43
2020-05-04,PALMERAH,86,3,83,90,16,74,81,33,15,7,26
2020-05-04,PANCORAN,44,1,43,35,8,27,47,26,7,3,11
2020-05-04,PASAR MINGGU,176,5,171,61,19,42,92,45,11,12,24
2020-05-04,PASAR REBO,35,6,29,28,10,18,36,11,6,4,15
2020-05-04,PENJARINGAN,107,3,104,72,10,62,74,42,6,8,18
2020-05-04,PESANGGRAHAN,82,1,81,44,9,35,67,27,12,14,14
2020-05-04,PULO GADUNG,155,6,149,87,33,54,103,51,16,10,26
2020-05-04,SAWAH BESAR,131,7,124,58,19,39,65,39,7,6,13
2020-05-04,SENEN,115,1,114,47,19,28,60,22,9,4,25
2020-05-04,SETIA BUDI,69,1,68,43,7,36,51,23,13,8,7
2020-05-04,TAMAN SARI,70,2,68,37,13,24,69,34,14,5,16
2020-05-04,TAMBORA,45,2,43,58,13,45,33,18,4,5,6
2020-05-04,TANAH ABANG,214,7,207,137,33,104,230,64,11,11,144
2020-05-04,TANJUNG PRIOK,210,13,197,150,49,101,165,85,11,17,52
2020-05-04,TEBET,119,1,118,84,15,69,103,44,18,11,30
2020-05-05,BELUM DIKETAHUI,2664,49,2615,2492,143,2349,343,256,50,6,31
2020-05-05,CAKUNG,184,4,180,78,28,50,92,43,13,9,27
2020-05-05,CEMPAKA PUTIH,233,4,229,111,15,96,77,34,7,7,29
2020-05-05,CENGKARENG,65,1,64,55,7,48,87,44,12,8,23
2020-05-05,CILANDAK,92,5,87,84,15,69,80,32,17,15,16
2020-05-05,CILINCING,245,5,240,53,22,31,47,25,1,5,16
2020-05-05,CIPAYUNG,84,6,78,60,23,37,46,25,6,1,14
2020-05-05,CIRACAS,130,4,126,53,14,39,43,17,7,6,13
2020-05-05,DUREN SAWIT,118,2,116,89,28,61,153,66,25,23,39
2020-05-05,GAMBIR,90,5,85,37,14,23,37,17,3,6,11
2020-05-05,GROGOL PETAMBURAN,136,4,132,72,13,59,116,49,35,11,21
2020-05-05,JAGAKARSA,83,0,83,55,10,45,72,30,15,5,22
2020-05-05,JATINEGARA,53,4,49,36,9,27,83,43,7,9,24
2020-05-05,JOHAR BARU,113,1,112,39,17,22,40,10,8,7,15
2020-05-05,KALI DERES,78,2,76,109,13,96,101,36,31,9,25
2020-05-05,KEBAYORAN BARU,65,4,61,70,33,37,60,20,29,3,8
2020-05-05,KEBAYORAN LAMA,73,2,71,77,21,56,104,47,15,16,26
2020-05-05,KEBON JERUK,153,2,151,111,20,91,132,54,31,11,36
2020-05-05,KELAPA GADING,238,1,237,99,22,77,101,41,19,7,34
2020-05-05,KEMAYORAN,170,8,162,83,33,50,80,22,9,12,37
2020-05-05,KEMBANGAN,53,3,50,72,17,55,86,31,21,5,29
2020-05-05,KEP. SERIBU SELATAN,38,1,37,5,0,5,9,0,0,0,9
2020-05-05,KEP. SERIBU UTARA,109,2,107,14,2,12,1,0,0,0,1
2020-05-05,KOJA,161,10,151,68,23,45,65,30,4,2,29
2020-05-05,KRAMAT JATI,64,3,61,40,15,25,85,33,9,9,34
2020-05-05,LUAR DKI JAKARTA,1316,24,1292,900,126,774,860,440,123,62,235
2020-05-05,MAKASAR,41,2,39,31,5,26,53,26,11,7,9
2020-05-05,MAMPANG PRAPATAN,141,1,140,31,12,19,45,18,8,6,13
2020-05-05,MATRAMAN,149,8,141,80,23,57,90,35,11,9,35
2020-05-05,MENTENG,59,1,58,31,13,18,59,28,7,8,16
2020-05-05,PADEMANGAN,139,4,135,53,9,44,94,28,6,6,54
2020-05-05,PALMERAH,88,3,85,91,16,75,85,35,16,7,27
2020-05-05,PANCORAN,48,1,47,35,8,27,47,25,8,3,11
2020-05-05,PASAR MINGGU,177,6,171,61,19,42,96,46,12,12,26
2020-05-05,PASAR REBO,35,6,29,28,10,18,38,11,6,4,17
2020-05-05,PENJARINGAN,107,3,104,72,10,62,74,42,7,7,18
2020-05-05,PESANGGRAHAN,82,1,81,44,9,35,67,26,13,14,14
2020-05-05,PULO GADUNG,156,6,150,88,34,54,104,51,18,10,25
2020-05-05,SAWAH BESAR,131,7,124,60,20,40,63,38,7,6,12
2020-05-05,SENEN,115,1,114,47,19,28,62,23,9,4,26
2020-05-05,SETIA BUDI,69,1,68,43,7,36,52,24,13,8,7
2020-05-05,TAMAN SARI,70,2,68,38,13,25,69,33,14,5,17
2020-05-05,TAMBORA,45,2,43,58,13,45,34,18,4,5,7
2020-05-05,TANAH ABANG,222,7,215,139,34,105,232,65,12,11,144
2020-05-05,TANJUNG PRIOK,210,13,197,151,50,101,174,86,13,17,58
2020-05-05,TEBET,119,1,118,84,15,69,103,43,19,11,30
2020-05-06,BELUM DIKETAHUI,2670,49,2621,2493,144,2349,386,297,50,9,30
2020-05-06,CAKUNG,184,4,180,78,28,50,91,43,12,9,27
2020-05-06,CEMPAKA PUTIH,234,5,229,111,15,96,77,34,7,7,29
2020-05-06,CENGKARENG,65,1,64,55,7,48,89,44,12,8,25
2020-05-06,CILANDAK,94,5,89,86,16,70,82,33,17,15,17
2020-05-06,CILINCING,245,5,240,54,22,32,47,25,1,5,16
2020-05-06,CIPAYUNG,84,6,78,61,24,37,46,26,6,1,13
2020-05-06,CIRACAS,131,4,127,53,14,39,42,17,7,6,12
2020-05-06,DUREN SAWIT,119,2,117,89,28,61,154,67,25,23,39
2020-05-06,GAMBIR,90,5,85,37,14,23,37,17,3,6,11
2020-05-06,GROGOL PETAMBURAN,136,4,132,73,13,60,121,46,38,11,26
2020-05-06,JAGAKARSA,83,0,83,55,10,45,72,30,15,5,22
2020-05-06,JATINEGARA,53,4,49,36,9,27,84,43,7,9,25
2020-05-06,JOHAR BARU,115,1,114,40,18,22,40,10,8,7,15
2020-05-06,KALI DERES,78,2,76,109,13,96,101,36,31,9,25
2020-05-06,KEBAYORAN BARU,65,4,61,70,33,37,60,20,29,3,8
2020-05-06,KEBAYORAN LAMA,75,2,73,77,21,56,105,47,15,16,27
2020-05-06,KEBON JERUK,153,2,151,111,20,91,131,54,31,11,35
2020-05-06,KELAPA GADING,238,1,237,99,22,77,101,41,19,7,34
2020-05-06,KEMAYORAN,170,8,162,85,35,50,80,22,9,12,37
2020-05-06,KEMBANGAN,54,3,51,72,17,55,87,32,21,5,29
2020-05-06,KEP. SERIBU SELATAN,38,1,37,5,0,5,9,0,0,0,9
2020-05-06,KEP. SERIBU UTARA,109,2,107,14,2,12,1,0,0,0,1
2020-05-06,KOJA,161,10,151,69,23,46,66,31,4,2,29
2020-05-06,KRAMAT JATI,64,3,61,40,15,25,86,34,9,9,34
2020-05-06,LUAR DKI JAKARTA,1330,24,1306,905,129,776,865,443,123,62,237
2020-05-06,MAKASAR,41,2,39,31,5,26,53,26,11,7,9
2020-05-06,MAMPANG PRAPATAN,141,1,140,31,12,19,46,19,8,6,13
2020-05-06,MATRAMAN,149,8,141,81,24,57,91,36,11,9,35
2020-05-06,MENTENG,60,1,59,31,13,18,59,28,7,8,16
2020-05-06,PADEMANGAN,140,5,135,55,11,44,94,28,6,6,54
2020-05-06,PALMERAH,88,3,85,91,16,75,85,34,16,8,27
2020-05-06,PANCORAN,52,1,51,35,8,27,47,25,8,3,11
2020-05-06,PASAR MINGGU,179,6,173,61,19,42,91,41,12,12,26
2020-05-06,PASAR REBO,35,6,29,28,10,18,39,11,6,4,18
2020-05-06,PENJARINGAN,107,3,104,72,10,62,74,41,7,8,18
2020-05-06,PESANGGRAHAN,82,1,81,44,9,35,67,26,13,14,14
2020-05-06,PULO GADUNG,159,6,153,88,34,54,106,51,18,10,27
2020-05-06,SAWAH BESAR,131,7,124,60,20,40,65,40,7,6,12
2020-05-06,SENEN,115,1,114,47,19,28,62,23,9,4,26
2020-05-06,SETIA BUDI,69,1,68,44,7,37,54,26,13,8,7
2020-05-06,TAMAN SARI,71,2,69,38,13,25,69,33,14,5,17
2020-05-06,TAMBORA,45,2,43,58,13,45,35,18,4,6,7
2020-05-06,TANAH ABANG,235,7,228,139,34,105,232,65,12,11,144
2020-05-06,TANJUNG PRIOK,210,13,197,151,50,101,177,89,13,17,58
2020-05-06,TEBET,128,1,127,84,15,69,103,43,19,11,30
2020-05-07,BELUM DIKETAHUI,2667,49,2618,2497,147,2350,405,311,50,14,30
2020-05-07,CAKUNG,189,5,184,79,29,50,91,43,12,9,27
2020-05-07,CEMPAKA PUTIH,234,5,229,113,15,98,79,36,6,7,30
2020-05-07,CENGKARENG,66,1,65,55,7,48,89,43,13,8,25
2020-05-07,CILANDAK,94,5,89,86,16,70,78,29,19,14,16
2020-05-07,CILINCING,248,5,243,55,22,33,47,25,1,5,16
2020-05-07,CIPAYUNG,86,8,78,61,24,37,48,28,6,1,13
2020-05-07,CIRACAS,134,5,129,54,14,40,42,16,7,6,13
2020-05-07,DUREN SAWIT,121,2,119,89,28,61,153,66,25,23,39
2020-05-07,GAMBIR,92,5,87,37,14,23,39,17,3,6,13
2020-05-07,GROGOL PETAMBURAN,136,4,132,73,13,60,123,47,38,11,27
2020-05-07,JAGAKARSA,87,0,87,57,10,47,72,30,15,5,22
2020-05-07,JATINEGARA,56,4,52,38,10,28,87,44,7,9,27
2020-05-07,JOHAR BARU,116,1,115,40,18,22,41,11,8,7,15
2020-05-07,KALI DERES,78,2,76,109,13,96,100,36,30,9,25
2020-05-07,KEBAYORAN BARU,66,4,62,71,34,37,61,20,29,3,9
2020-05-07,KEBAYORAN LAMA,75,2,73,78,21,57,106,44,17,17,28
2020-05-07,KEBON JERUK,156,2,154,111,20,91,130,53,30,11,36
2020-05-07,KELAPA GADING,238,1,237,100,23,77,102,40,19,7,36
2020-05-07,KEMAYORAN,173,8,165,85,35,50,80,20,11,12,37
2020-05-07,KEMBANGAN,54,3,51,73,18,55,91,32,21,5,33
2020-05-07,KEP. SERIBU SELATAN,38,1,37,5,0,5,9,0,0,0,9
2020-05-07,KEP. SERIBU UTARA,109,2,107,14,2,12,1,0,0,0,1
2020-05-07,KOJA,161,10,151,71,23,48,72,27,5,4,36
2020-05-07,KRAMAT JATI,65,3,62,41,16,25,87,35,9,9,34
2020-05-07,LUAR DKI JAKARTA,1373,26,1347,914,136,778,863,440,123,62,238
2020-05-07,MAKASAR,41,2,39,31,5,26,53,26,11,7,9
2020-05-07,MAMPANG PRAPATAN,143,1,142,31,12,19,46,19,8,6,13
2020-05-07,MATRAMAN,155,8,147,84,26,58,95,37,10,10,38
2020-05-07,MENTENG,60,1,59,31,13,18,61,27,7,8,19
2020-05-07,PADEMANGAN,148,6,142,56,12,44,96,30,6,6,54
2020-05-07,PALMERAH,88,3,85,91,16,75,88,34,16,8,30
2020-05-07,PANCORAN,58,1,57,35,8,27,47,25,8,3,11
2020-05-07,PASAR MINGGU,186,7,179,62,19,43,91,40,12,12,27
2020-05-07,PASAR REBO,38,6,32,29,11,18,39,12,6,4,17
2020-05-07,PENJARINGAN,107,3,104,73,11,62,74,40,8,8,18
2020-05-07,PESANGGRAHAN,82,1,81,44,9,35,70,26,13,15,16
2020-05-07,PULO GADUNG,161,6,155,88,34,54,105,50,18,10,27
2020-05-07,SAWAH BESAR,134,7,127,64,20,44,68,41,7,6,14
2020-05-07,SENEN,119,1,118,48,19,29,69,25,9,4,31
2020-05-07,SETIA BUDI,70,1,69,45,8,37,53,26,12,8,7
2020-05-07,TAMAN SARI,77,2,75,40,13,27,70,33,15,5,17
2020-05-07,TAMBORA,46,2,44,59,14,45,33,16,4,6,7
2020-05-07,TANAH ABANG,247,7,240,140,34,106,241,66,12,11,152
2020-05-07,TANJUNG PRIOK,216,14,202,153,52,101,179,89,13,18,59
2020-05-07,TEBET,130,1,129,85,16,69,101,41,19,11,30
2020-05-08,BELUM DIKETAHUI,2400,50,2350,1993,145,1848,425,333,53,10,29
2020-05-08,CAKUNG,192,5,187,78,28,50,93,46,11,9,27
2020-05-08,CEMPAKA PUTIH,243,5,238,140,15,125,80,38,6,7,29
2020-05-08,CENGKARENG,78,1,77,62,7,55,89,43,13,8,25
2020-05-08,CILANDAK,100,5,95,87,17,70,79,29,20,14,16
2020-05-08,CILINCING,257,5,252,56,22,34,47,25,1,5,16
2020-05-08,CIPAYUNG,86,8,78,61,24,37,50,30,7,1,12
2020-05-08,CIRACAS,133,5,128,58,14,44,42,16,7,6,13
2020-05-08,DUREN SAWIT,123,2,121,87,26,61,153,66,25,23,39
2020-05-08,GAMBIR,92,5,87,40,14,26,43,20,3,7,13
2020-05-08,GROGOL PETAMBURAN,172,4,168,120,12,108,124,47,42,11,24
2020-05-08,JAGAKARSA,92,0,92,59,10,49,74,31,15,6,22
2020-05-08,JATINEGARA,56,4,52,38,10,28,91,48,7,10,26
2020-05-08,JOHAR BARU,119,1,118,41,18,23,43,13,8,7,15
2020-05-08,KALI DERES,150,2,148,158,12,146,103,38,31,9,25
2020-05-08,KEBAYORAN BARU,66,4,62,73,35,38,62,21,29,3,9
2020-05-08,KEBAYORAN LAMA,77,3,74,88,25,63,109,43,22,17,27
2020-05-08,KEBON JERUK,166,2,164,114,20,94,133,55,31,11,36
2020-05-08,KELAPA GADING,241,1,240,100,22,78,102,39,20,7,36
2020-05-08,KEMAYORAN,178,8,170,123,36,87,85,24,11,12,38
2020-05-08,KEMBANGAN,55,3,52,71,18,53,93,31,24,5,33
2020-05-08,KEP. SERIBU SELATAN,38,1,37,5,0,5,9,0,0,0,9
2020-05-08,KEP. SERIBU UTARA,109,2,107,14,2,12,2,1,0,0,1
2020-05-08,KOJA,207,11,196,131,23,108,73,27,6,4,36
2020-05-08,KRAMAT JATI,65,3,62,42,16,26,89,36,9,9,35
2020-05-08,LUAR DKI JAKARTA,1374,26,1348,917,137,780,888,460,132,63,233
2020-05-08,MAKASAR,41,2,39,31,5,26,53,26,11,7,9
2020-05-08,MAMPANG PRAPATAN,144,1,143,32,12,20,46,19,8,6,13
2020-05-08,MATRAMAN,156,8,148,84,25,59,95,38,9,10,38
2020-05-08,MENTENG,66,1,65,33,13,20,61,27,7,8,19
2020-05-08,PADEMANGAN,202,6,196,57,12,45,98,31,7,6,54
2020-05-08,PALMERAH,158,3,155,171,18,153,91,35,18,8,30
2020-05-08,PANCORAN,58,1,57,36,8,28,47,25,8,3,11
2020-05-08,PASAR MINGGU,187,7,180,64,21,43,95,43,13,12,27
2020-05-08,PASAR REBO,38,6,32,29,11,18,39,12,6,4,17
2020-05-08,PENJARINGAN,108,3,105,73,11,62,75,41,8,8,18
2020-05-08,PESANGGRAHAN,83,1,82,44,8,36,71,26,14,15,16
2020-05-08,PULO GADUNG,162,6,156,88,34,54,111,54,19,11,27
2020-05-08,SAWAH BESAR,142,8,134,134,22,112,69,42,7,6,14
2020-05-08,SENEN,121,1,120,49,19,30,70,25,10,4,31
2020-05-08,SETIA BUDI,71,2,69,45,8,37,53,25,13,8,7
2020-05-08,TAMAN SARI,84,2,82,43,13,30,71,34,15,5,17
2020-05-08,TAMBORA,46,2,44,59,14,45,41,17,4,6,14
2020-05-08,TANAH ABANG,246,7,239,143,34,109,250,68,20,11,151
2020-05-08,TANJUNG PRIOK,282,14,268,276,54,222,181,91,13,18,59
2020-05-08,TEBET,145,1,144,84,15,69,103,42,20,11,30
2020-05-09,BELUM DIKETAHUI,2410,51,2359,1993,145,1848,446,354,50,13,29
2020-05-09,CAKUNG,193,5,188,78,28,50,93,46,11,9,27
2020-05-09,CEMPAKA PUTIH,243,5,238,140,15,125,80,38,6,7,29
2020-05-09,CENGKARENG,78,1,77,62,7,55,89,43,13,8,25
2020-05-09,CILANDAK,132,8,124,99,22,77,79,29,20,14,16
2020-05-09,CILINCING,258,5,253,56,22,34,47,25,1,5,16
2020-05-09,CIPAYUNG,90,8,82,61,24,37,51,31,7,1,12
2020-05-09,CIRACAS,142,5,137,58,14,44,42,16,7,6,13
2020-05-09,DUREN SAWIT,127,2,125,87,26,61,158,65,26,23,44
2020-05-09,GAMBIR,93,5,88,40,14,26,44,21,3,7,13
2020-05-09,GROGOL PETAMBURAN,172,4,168,120,12,108,124,48,41,11,24
2020-05-09,JAGAKARSA,108,1,107,63,11,52,74,31,16,6,21
2020-05-09,JATINEGARA,56,4,52,38,10,28,93,48,7,10,28
2020-05-09,JOHAR BARU,120,1,119,41,18,23,44,14,8,7,15
2020-05-09,KALI DERES,153,2,151,158,12,146,103,38,31,9,25
2020-05-09,KEBAYORAN BARU,69,4,65,75,36,39,62,20,30,3,9
2020-05-09,KEBAYORAN LAMA,77,3,74,88,25,63,111,43,22,18,28
2020-05-09,KEBON JERUK,167,2,165,114,20,94,133,54,31,12,36
2020-05-09,KELAPA GADING,241,1,240,100,22,78,102,39,20,7,36
2020-05-09,KEMAYORAN,179,8,171,123,36,87,89,25,11,12,41
2020-05-09,KEMBANGAN,57,3,54,71,18,53,93,31,24,5,33
2020-05-09,KEP. SERIBU SELATAN,38,1,37,5,0,5,9,0,0,0,9
2020-05-09,KEP. SERIBU UTARA,109,2,107,14,2,12,1,0,0,0,1
2020-05-09,KOJA,209,11,198,131,23,108,73,27,6,4,36
2020-05-09,KRAMAT JATI,65,3,62,42,16,26,91,36,9,9,37
2020-05-09,LUAR DKI JAKARTA,1411,26,1385,922,138,784,891,461,133,63,234
2020-05-09,MAKASAR,41,2,39,31,5,26,53,26,11,7,9
2020-05-09,MAMPANG PRAPATAN,144,1,143,32,12,20,46,19,8,6,13
2020-05-09,MATRAMAN,156,8,148,84,25,59,98,40,9,10,39
2020-05-09,MENTENG,68,1,67,33,13,20,61,27,7,8,19
2020-05-09,PADEMANGAN,203,6,197,57,12,45,100,33,7,6,54
2020-05-09,PALMERAH,158,3,155,171,18,153,92,36,18,8,30
2020-05-09,PANCORAN,58,1,57,36,8,28,47,25,9,3,10
2020-05-09,PASAR MINGGU,190,7,183,65,21,44,95,42,15,12,26
2020-05-09,PASAR REBO,40,6,34,29,11,18,43,13,7,4,19
2020-05-09,PENJARINGAN,108,3,105,73,11,62,76,42,8,8,18
2020-05-09,PESANGGRAHAN,83,1,82,44,8,36,72,26,14,15,17
2020-05-09,PULO GADUNG,162,6,156,88,34,54,111,54,19,11,27
2020-05-09,SAWAH BESAR,144,8,136,134,22,112,69,42,7,6,14
2020-05-09,SENEN,121,1,120,49,19,30,69,24,10,4,31
2020-05-09,SETIA BUDI,72,3,69,45,8,37,54,25,13,8,8
2020-05-09,TAMAN SARI,84,2,82,43,13,30,71,34,15,5,17
2020-05-09,TAMBORA,46,2,44,59,14,45,42,18,4,6,14
2020-05-09,TANAH ABANG,247,7,240,143,34,109,250,68,20,11,151
2020-05-09,TANJUNG PRIOK,282,14,268,276,54,222,183,92,13,19,59
2020-05-09,TEBET,145,1,144,84,15,69,104,43,20,11,30
2020-05-10,BELUM DIKETAHUI,2404,51,2353,2004,149,1855,396,302,30,8,56
2020-05-10,CAKUNG,194,5,189,82,29,53,97,49,11,9,28
2020-05-10,CEMPAKA PUTIH,243,5,238,140,15,125,82,38,8,7,29
2020-05-10,CENGKARENG,79,1,78,62,7,55,95,46,14,8,27
2020-05-10,CILANDAK,138,8,130,102,24,78,81,28,23,14,16
2020-05-10,CILINCING,262,7,255,59,24,35,49,25,2,5,17
2020-05-10,CIPAYUNG,92,8,84,62,25,37,51,31,7,1,12
2020-05-10,CIRACAS,142,5,137,58,14,44,45,18,8,6,13
2020-05-10,DUREN SAWIT,128,3,125,89,28,61,162,64,29,24,45
2020-05-10,GAMBIR,93,5,88,40,14,26,47,24,3,7,13
2020-05-10,GROGOL PETAMBURAN,172,4,168,120,12,108,125,49,41,11,24
2020-05-10,JAGAKARSA,109,1,108,64,12,52,75,32,16,6,21
2020-05-10,JATINEGARA,56,4,52,39,10,29,104,55,12,10,27
2020-05-10,JOHAR BARU,141,2,139,42,19,23,45,15,8,7,15
2020-05-10,KALI DERES,153,2,151,158,12,146,106,40,32,9,25
2020-05-10,KEBAYORAN BARU,70,5,65,75,36,39,64,21,31,3,9
2020-05-10,KEBAYORAN LAMA,77,3,74,88,25,63,113,44,23,18,28
2020-05-10,KEBON JERUK,167,2,165,115,20,95,145,60,32,12,41
2020-05-10,KELAPA GADING,241,1,240,100,22,78,102,39,20,7,36
2020-05-10,KEMAYORAN,179,8,171,124,36,88,91,25,12,12,42
2020-05-10,KEMBANGAN,57,3,54,71,18,53,98,35,24,5,34
2020-05-10,KEP. SERIBU SELATAN,38,1,37,5,0,5,12,3,0,0,9
2020-05-10,KEP. SERIBU UTARA,109,2,107,14,2,12,1,0,0,0,1
2020-05-10,KOJA,217,11,206,131,23,108,76,28,6,4,38
2020-05-10,KRAMAT JATI,79,3,76,43,16,27,94,39,10,9,36
2020-05-10,LUAR DKI JAKARTA,1434,29,1405,935,143,792,986,506,152,64,264
2020-05-10,MAKASAR,42,2,40,31,5,26,53,26,11,7,9
2020-05-10,MAMPANG PRAPATAN,146,1,145,32,12,20,48,19,9,7,13
2020-05-10,MATRAMAN,157,9,148,87,26,61,100,40,10,10,40
2020-05-10,MENTENG,69,2,67,33,13,20,62,27,8,8,19
2020-05-10,PADEMANGAN,204,6,198,57,12,45,102,33,7,6,56
2020-05-10,PALMERAH,161,3,158,171,18,153,106,39,19,11,37
2020-05-10,PANCORAN,70,1,69,36,8,28,49,25,9,3,12
2020-05-10,PASAR MINGGU,193,7,186,70,26,44,98,42,16,13,27
2020-05-10,PASAR REBO,43,6,37,29,11,18,43,13,7,4,19
2020-05-10,PENJARINGAN,108,3,105,75,13,62,77,42,9,8,18
2020-05-10,PESANGGRAHAN,86,1,85,44,8,36,73,26,15,15,17
2020-05-10,PULO GADUNG,162,6,156,88,34,54,115,57,20,11,27
2020-05-10,SAWAH BESAR,144,8,136,134,22,112,73,45,8,6,14
2020-05-10,SENEN,122,1,121,50,19,31,72,26,10,4,32
2020-05-10,SETIA BUDI,73,3,70,45,8,37,54,24,13,9,8
2020-05-10,TAMAN SARI,84,2,82,43,13,30,73,34,16,5,18
2020-05-10,TAMBORA,48,2,46,59,14,45,44,19,4,7,14
2020-05-10,TANAH ABANG,248,7,241,143,34,109,263,72,20,13,158
2020-05-10,TANJUNG PRIOK,293,14,279,277,55,222,190,97,13,20,60
2020-05-10,TEBET,145,1,144,86,17,69,103,38,25,11,29
2020-05-11,BELUM DIKETAHUI,2396,51,2345,2005,149,1856,387,221,30,10,126
2020-05-11,CAKUNG,195,5,190,85,30,55,97,45,13,9,30
2020-05-11,CEMPAKA PUTIH,251,5,246,150,17,133,82,37,9,7,29
2020-05-11,CENGKARENG,85,1,84,66,8,58,99,47,15,8,29
2020-05-11,CILANDAK,142,8,134,103,24,79,81,27,24,14,16
2020-05-11,CILINCING,262,7,255,60,24,36,49,26,1,5,17
2020-05-11,CIPAYUNG,103,9,94,63,26,37,57,30,8,1,18
2020-05-11,CIRACAS,144,6,138,61,15,46,45,17,8,7,13
2020-05-11,DUREN SAWIT,132,4,128,94,30,64,163,61,32,24,46
2020-05-11,GAMBIR,107,6,101,56,18,38,46,21,5,7,13
2020-05-11,GROGOL PETAMBURAN,183,5,178,130,16,114,126,49,43,11,23
2020-05-11,JAGAKARSA,112,2,110,67,13,54,75,31,17,6,21
2020-05-11,JATINEGARA,60,4,56,41,12,29,104,50,13,10,31
2020-05-11,JOHAR BARU,148,2,146,47,20,27,45,13,8,9,15
2020-05-11,KALI DERES,154,2,152,159,12,147,106,40,32,9,25
2020-05-11,KEBAYORAN BARU,72,5,67,78,37,41,66,22,32,3,9
2020-05-11,KEBAYORAN LAMA,82,3,79,91,27,64,113,43,24,18,28
2020-05-11,KEBON JERUK,173,4,169,127,24,103,148,59,33,12,44
2020-05-11,KELAPA GADING,245,1,244,107,26,81,104,40,20,7,37
2020-05-11,KEMAYORAN,183,9,174,129,38,91,91,25,12,12,42
2020-05-11,KEMBANGAN,60,3,57,79,20,59,99,36,24,5,34
2020-05-11,KEP. SERIBU SELATAN,38,1,37,5,0,5,12,3,0,0,9
2020-05-11,KEP. SERIBU UTARA,109,2,107,14,2,12,1,0,0,0,1
2020-05-11,KOJA,218,11,207,133,24,109,79,30,6,4,39
2020-05-11,KRAMAT JATI,80,3,77,44,16,28,95,38,10,10,37
2020-05-11,LUAR DKI JAKARTA,1516,30,1486,1019,173,846,998,502,161,64,271
2020-05-11,MAKASAR,44,2,42,34,7,27,55,26,12,7,10
2020-05-11,MAMPANG PRAPATAN,148,1,147,34,14,20,49,19,9,7,14
2020-05-11,MATRAMAN,161,10,151,93,30,63,103,43,9,10,41
2020-05-11,MENTENG,78,3,75,48,23,25,62,28,8,8,18
2020-05-11,PADEMANGAN,206,6,200,60,12,48,104,33,7,6,58
2020-05-11,PALMERAH,166,4,162,179,23,156,107,40,19,11,37
2020-05-11,PANCORAN,71,2,69,36,8,28,49,25,9,3,12
2020-05-11,PASAR MINGGU,202,9,193,70,26,44,99,43,16,13,27
2020-05-11,PASAR REBO,46,6,40,31,11,20,41,12,7,4,18
2020-05-11,PENJARINGAN,114,4,110,81,15,66,77,42,9,8,18
2020-05-11,PESANGGRAHAN,91,2,89,48,10,38,73,26,15,15,17
2020-05-11,PULO GADUNG,175,6,169,101,37,64,117,58,21,11,27
2020-05-11,SAWAH BESAR,156,8,148,173,36,137,74,46,8,6,14
2020-05-11,SENEN,146,3,143,71,29,42,73,27,10,4,32
2020-05-11,SETIA BUDI,98,4,94,52,8,44,53,20,14,9,10
2020-05-11,TAMAN SARI,90,2,88,48,15,33,74,34,16,5,19
2020-05-11,TAMBORA,60,3,57,62,17,45,45,18,4,9,14
2020-05-11,TANAH ABANG,252,7,245,150,37,113,274,74,20,13,167
2020-05-11,TANJUNG PRIOK,300,15,285,284,56,228,195,94,17,21,63
2020-05-11,TEBET,148,1,147,90,18,72,103,37,26,11,29
2020-05-12,BELUM DIKETAHUI,2433,11,2422,2057,55,2002,390,213,41,5,131
2020-05-12,CAKUNG,195,4,191,87,12,75,102,37,22,9,34
2020-05-12,CEMPAKA PUTIH,267,5,262,161,9,152,82,29,17,7,29
2020-05-12,CENGKARENG,86,0,86,66,1,65,100,43,20,8,29
2020-05-12,CILANDAK,219,9,210,143,45,98,82,18,33,14,17
2020-05-12,CILINCING,262,5,257,60,12,48,60,25,2,6,27
2020-05-12,CIPAYUNG,103,8,95,64,14,50,56,22,15,1,18
2020-05-12,CIRACAS,146,5,141,61,9,52,45,13,11,8,13
2020-05-12,DUREN SAWIT,133,4,129,95,4,91,172,39,53,24,56
2020-05-12,GAMBIR,108,2,106,58,5,53,46,19,7,7,13
2020-05-12,GROGOL PETAMBURAN,184,2,182,130,5,125,127,39,53,11,24
2020-05-12,JAGAKARSA,182,8,174,112,33,79,78,21,28,6,23
2020-05-12,JATINEGARA,63,2,61,41,4,37,108,34,26,10,38
2020-05-12,JOHAR BARU,157,3,154,47,7,40,47,9,9,9,20
2020-05-12,KALI DERES,154,1,153,159,3,156,106,29,43,9,25
2020-05-12,KEBAYORAN BARU,109,3,106,84,16,68,66,11,43,3,9
2020-05-12,KEBAYORAN LAMA,108,4,104,113,23,90,113,31,36,18,28
2020-05-12,KEBON JERUK,175,2,173,127,7,120,148,45,47,12,44
2020-05-12,KELAPA GADING,245,0,245,108,10,98,104,31,28,8,37
2020-05-12,KEMAYORAN,185,8,177,133,13,120,91,16,20,12,43
2020-05-12,KEMBANGAN,60,0,60,79,2,77,100,29,31,5,35
2020-05-12,KEP. SERIBU SELATAN,38,1,37,5,0,5,12,3,0,0,9
2020-05-12,KEP. SERIBU UTARA,109,2,107,14,0,14,1,0,0,0,1
2020-05-12,KOJA,218,4,214,134,12,122,80,24,12,5,39
2020-05-12,KRAMAT JATI,80,1,79,44,2,42,99,29,18,10,42
2020-05-12,LUAR DKI JAKARTA,1530,13,1517,1031,61,970,1024,418,257,66,283
2020-05-12,MAKASAR,46,1,45,35,4,31,57,24,15,7,11
2020-05-12,MAMPANG PRAPATAN,158,1,157,40,7,33,49,15,13,7,14
2020-05-12,MATRAMAN,165,7,158,95,12,83,105,33,19,10,43
2020-05-12,MENTENG,80,3,77,48,11,37,63,26,10,9,18
2020-05-12,PADEMANGAN,228,4,224,62,4,58,104,32,8,6,58
2020-05-12,PALMERAH,166,2,164,180,6,174,111,32,27,11,41
2020-05-12,PANCORAN,86,1,85,55,5,50,50,24,10,3,13
2020-05-12,PASAR MINGGU,280,12,268,128,47,81,99,35,24,13,27
2020-05-12,PASAR REBO,46,2,44,31,4,27,42,9,10,4,19
2020-05-12,PENJARINGAN,114,3,111,82,7,75,78,27,25,8,18
2020-05-12,PESANGGRAHAN,128,5,123,66,14,52,75,21,21,15,18
2020-05-12,PULO GADUNG,178,1,177,102,10,92,120,44,36,11,29
2020-05-12,SAWAH BESAR,161,6,155,174,17,157,76,43,13,6,14
2020-05-12,SENEN,148,3,145,72,10,62,73,23,14,4,32
2020-05-12,SETIA BUDI,101,4,97,57,8,49,53,16,18,9,10
2020-05-12,TAMAN SARI,90,2,88,48,4,44,77,33,17,5,22
2020-05-12,TAMBORA,60,2,58,62,6,56,45,16,6,9,14
2020-05-12,TANAH ABANG,254,2,252,155,7,148,276,64,29,14,169
2020-05-12,TANJUNG PRIOK,302,11,291,287,26,261,207,77,34,22,74
2020-05-12,TEBET,161,2,159,103,14,89,104,22,41,11,30
2020-05-13,BELUM DIKETAHUI,2434,11,2423,2058,57,2001,351,171,38,4,138
2020-05-13,CAKUNG,214,4,210,91,12,79,103,36,23,9,35
2020-05-13,CEMPAKA PUTIH,268,5,263,162,9,153,84,29,21,7,27
2020-05-13,CENGKARENG,87,0,87,67,1,66,100,42,20,8,30
2020-05-13,CILANDAK,222,9,213,145,46,99,82,18,33,14,17
2020-05-13,CILINCING,300,8,292,61,12,49,61,26,2,6,27
2020-05-13,CIPAYUNG,105,8,97,65,15,50,59,23,16,1,19
2020-05-13,CIRACAS,158,5,153,62,9,53,45,13,10,8,14
2020-05-13,DUREN SAWIT,150,4,146,97,4,93,175,39,53,24,59
2020-05-13,GAMBIR,112,2,110,59,6,53,47,20,8,7,12
2020-05-13,GROGOL PETAMBURAN,210,2,208,130,5,125,133,40,54,11,28
2020-05-13,JAGAKARSA,192,8,184,113,34,79,79,21,28,6,24
2020-05-13,JATINEGARA,70,2,68,42,4,38,111,36,27,10,38
2020-05-13,JOHAR BARU,158,3,155,47,7,40,49,9,9,9,22
2020-05-13,KALI DERES,156,1,155,170,3,167,107,30,43,9,25
2020-05-13,KEBAYORAN BARU,110,3,107,86,16,70,69,12,43,3,11
2020-05-13,KEBAYORAN LAMA,115,4,111,116,24,92,114,32,36,18,28
2020-05-13,KEBON JERUK,197,2,195,129,7,122,156,47,47,12,50
2020-05-13,KELAPA GADING,248,0,248,108,10,98,107,31,29,8,39
2020-05-13,KEMAYORAN,189,8,181,134,13,121,99,18,19,12,50
2020-05-13,KEMBANGAN,62,0,62,80,2,78,100,30,31,5,34
2020-05-13,KEP. SERIBU SELATAN,38,1,37,5,0,5,13,3,0,0,10
2020-05-13,KEP. SERIBU UTARA,110,2,108,14,0,14,1,0,0,0,1
2020-05-13,KOJA,222,5,217,135,12,123,85,25,12,5,43
2020-05-13,KRAMAT JATI,82,1,81,44,2,42,99,28,21,10,40
2020-05-13,LUAR DKI JAKARTA,1563,15,1548,1040,64,976,1059,429,259,67,304
2020-05-13,MAKASAR,47,1,46,35,4,31,57,23,15,7,12
2020-05-13,MAMPANG PRAPATAN,159,1,158,40,7,33,51,16,13,7,15
2020-05-13,MATRAMAN,167,7,160,95,12,83,107,34,19,10,44
2020-05-13,MENTENG,80,3,77,48,11,37,66,26,10,9,21
2020-05-13,PADEMANGAN,249,4,245,67,4,63,120,32,9,6,73
2020-05-13,PALMERAH,167,2,165,180,6,174,115,33,27,12,43
2020-05-13,PANCORAN,88,2,86,55,5,50,50,24,10,3,13
2020-05-13,PASAR MINGGU,296,12,284,132,49,83,105,37,25,13,30
2020-05-13,PASAR REBO,79,2,77,31,4,27,42,9,10,4,19
2020-05-13,PENJARINGAN,116,3,113,82,7,75,87,27,25,8,27
2020-05-13,PESANGGRAHAN,132,5,127,66,14,52,76,21,21,15,19
2020-05-13,PULO GADUNG,187,1,186,104,10,94,122,44,36,11,31
2020-05-13,SAWAH BESAR,163,6,157,174,17,157,77,42,14,7,14
2020-05-13,SENEN,157,3,154,72,10,62,76,21,16,4,35
2020-05-13,SETIA BUDI,105,4,101,59,8,51,57,19,18,9,11
2020-05-13,TAMAN SARI,92,2,90,48,4,44,77,33,17,5,22
2020-05-13,TAMBORA,61,3,58,62,6,56,50,19,6,9,16
2020-05-13,TANAH ABANG,329,2,327,158,7,151,286,63,29,15,179
2020-05-13,TANJUNG PRIOK,304,11,293,288,26,262,221,78,34,23,86
2020-05-13,TEBET,163,2,161,103,14,89,107,24,41,11,31
2020-05-14,BELUM DIKETAHUI,2452,11,2441,2059,58,2001,358,173,38,5,142
2020-05-14,CAKUNG,219,4,215,93,13,80,106,37,23,9,37
2020-05-14,CEMPAKA PUTIH,275,5,270,165,10,155,86,30,21,7,28
2020-05-14,CENGKARENG,106,0,106,68,2,66,106,43,20,8,35
2020-05-14,CILANDAK,230,9,221,149,49,100,85,19,33,14,19
2020-05-14,CILINCING,303,8,295,64,14,50,61,26,2,6,27
2020-05-14,CIPAYUNG,109,8,101,66,15,51,59,23,16,1,19
2020-05-14,CIRACAS,166,5,161,63,9,54,46,13,10,8,15
2020-05-14,DUREN SAWIT,164,4,160,99,6,93,186,40,53,24,69
2020-05-14,GAMBIR,116,2,114,60,6,54,48,20,8,7,13
2020-05-14,GROGOL PETAMBURAN,246,3,243,139,8,131,136,38,56,12,30
2020-05-14,JAGAKARSA,195,8,187,113,34,79,79,21,28,6,24
2020-05-14,JATINEGARA,77,2,75,45,7,38,114,38,27,10,39
2020-05-14,JOHAR BARU,161,3,158,48,7,41,51,9,9,10,23
2020-05-14,KALI DERES,161,1,160,173,4,169,108,31,43,9,25
2020-05-14,KEBAYORAN BARU,113,3,110,86,16,70,69,12,43,3,11
2020-05-14,KEBAYORAN LAMA,151,4,147,122,29,93,119,34,36,18,31
2020-05-14,KEBON JERUK,275,2,273,152,19,133,162,51,47,12,52
2020-05-14,KELAPA GADING,250,0,250,108,10,98,108,31,29,8,40
2020-05-14,KEMAYORAN,195,8,187,135,14,121,101,19,19,13,50
2020-05-14,KEMBANGAN,113,0,113,96,7,89,108,32,31,5,40
2020-05-14,KEP. SERIBU SELATAN,38,1,37,5,0,5,13,3,0,0,10
2020-05-14,KEP. SERIBU UTARA,121,2,119,14,0,14,1,0,0,0,1
2020-05-14,KOJA,227,5,222,136,12,124,87,27,12,5,43
2020-05-14,KRAMAT JATI,85,1,84,44,2,42,101,29,21,10,41
2020-05-14,LUAR DKI JAKARTA,1867,15,1852,1073,75,998,1082,436,259,67,320
2020-05-14,MAKASAR,52,1,51,37,5,32,57,23,15,7,12
2020-05-14,MAMPANG PRAPATAN,165,1,164,40,7,33,50,16,13,7,14
2020-05-14,MATRAMAN,175,7,168,95,12,83,107,34,19,10,44
2020-05-14,MENTENG,82,3,79,49,11,38,67,27,10,9,21
2020-05-14,PADEMANGAN,252,4,248,67,4,63,130,33,9,6,82
2020-05-14,PALMERAH,305,2,303,213,22,191,119,37,27,12,43
2020-05-14,PANCORAN,94,2,92,55,5,50,52,25,10,3,14
2020-05-14,PASAR MINGGU,301,12,289,132,49,83,105,37,25,13,30
2020-05-14,PASAR REBO,84,2,82,32,4,28,46,9,10,4,23
2020-05-14,PENJARINGAN,120,3,117,82,7,75,122,30,25,8,59
2020-05-14,PESANGGRAHAN,142,5,137,68,14,54,76,21,21,15,19
2020-05-14,PULO GADUNG,197,1,196,108,11,97,122,44,36,11,31
2020-05-14,SAWAH BESAR,167,6,161,174,17,157,82,43,14,7,18
2020-05-14,SENEN,161,3,158,73,10,63,78,21,16,4,37
2020-05-14,SETIA BUDI,109,4,105,60,9,51,58,18,18,9,13
2020-05-14,TAMAN SARI,96,2,94,49,5,44,80,33,17,5,25
2020-05-14,TAMBORA,75,3,72,72,11,61,57,20,6,9,22
2020-05-14,TANAH ABANG,390,2,388,169,11,158,291,64,29,15,183
2020-05-14,TANJUNG PRIOK,312,11,301,288,26,262,230,83,34,24,89
2020-05-14,TEBET,165,2,163,104,14,90,108,24,41,11,32
2020-05-15,BELUM DIKETAHUI,2669,4,2665,2036,28,2008,339,171,37,5,126
2020-05-15,CAKUNG,241,2,239,94,12,82,110,38,24,9,39
2020-05-15,CEMPAKA PUTIH,332,3,329,166,5,161,87,31,21,7,28
2020-05-15,CENGKARENG,192,0,192,68,1,67,107,43,20,8,36
2020-05-15,CILANDAK,235,6,229,152,38,114,87,20,33,14,20
2020-05-15,CILINCING,390,7,383,66,13,53,63,26,2,7,28
2020-05-15,CIPAYUNG,117,7,110,72,12,60,59,23,16,1,19
2020-05-15,CIRACAS,197,5,192,67,5,62,46,13,10,8,15
2020-05-15,DUREN SAWIT,214,5,209,104,7,97,188,42,53,25,68
2020-05-15,GAMBIR,170,1,169,61,5,56,49,20,8,7,14
2020-05-15,GROGOL PETAMBURAN,302,2,300,139,8,131,137,39,56,12,30
2020-05-15,JAGAKARSA,314,9,305,123,31,92,79,20,28,7,24
2020-05-15,JATINEGARA,249,1,248,45,6,39,113,34,29,11,39
2020-05-15,JOHAR BARU,197,3,194,57,12,45,52,11,9,10,22
2020-05-15,KALI DERES,327,0,327,175,3,172,111,33,43,9,26
2020-05-15,KEBAYORAN BARU,115,2,113,89,13,76,69,12,43,3,11
2020-05-15,KEBAYORAN LAMA,175,1,174,138,31,107,123,35,37,18,33
2020-05-15,KEBON JERUK,531,1,530,154,17,137,165,51,47,13,54
2020-05-15,KELAPA GADING,303,1,302,110,8,102,109,31,30,8,40
2020-05-15,KEMAYORAN,241,4,237,136,9,127,103,21,19,13,50
2020-05-15,KEMBANGAN,126,1,125,96,6,90,111,32,31,5,43
2020-05-15,KEP. SERIBU SELATAN,91,0,91,5,0,5,13,3,0,0,10
2020-05-15,KEP. SERIBU UTARA,163,3,160,14,0,14,1,0,0,0,1
2020-05-15,KOJA,244,3,241,139,9,130,91,27,12,5,47
2020-05-15,KRAMAT JATI,95,0,95,44,2,42,102,30,21,10,41
2020-05-15,LUAR DKI JAKARTA,1934,21,1913,1115,87,1028,1089,437,262,68,322
2020-05-15,MAKASAR,64,2,62,38,4,34,59,24,16,7,12
2020-05-15,MAMPANG PRAPATAN,198,1,197,40,5,35,53,17,13,7,16
2020-05-15,MATRAMAN,322,6,316,98,9,89,110,35,19,10,46
2020-05-15,MENTENG,94,2,92,49,7,42,67,27,10,9,21
2020-05-15,PADEMANGAN,318,2,316,68,4,64,134,35,9,6,84
2020-05-15,PALMERAH,313,1,312,216,21,195,126,43,27,12,44
2020-05-15,PANCORAN,121,3,118,55,3,52,53,25,10,3,15
2020-05-15,PASAR MINGGU,359,11,348,132,28,104,105,38,25,13,29
2020-05-15,PASAR REBO,94,1,93,34,2,32,47,10,10,4,23
2020-05-15,PENJARINGAN,411,0,411,82,4,78,122,30,25,8,59
2020-05-15,PESANGGRAHAN,166,8,158,87,17,70,77,21,21,15,20
2020-05-15,PULO GADUNG,267,0,267,114,14,100,122,44,36,11,31
2020-05-15,SAWAH BESAR,181,0,181,174,13,161,82,43,14,7,18
2020-05-15,SENEN,226,2,224,73,7,66,79,21,16,4,38
2020-05-15,SETIA BUDI,174,3,171,60,6,54,58,18,18,9,13
2020-05-15,TAMAN SARI,101,1,100,49,4,45,84,34,17,5,28
2020-05-15,TAMBORA,127,2,125,72,10,62,61,21,6,9,25
2020-05-15,TANAH ABANG,527,1,526,169,9,160,292,63,29,17,183
2020-05-15,TANJUNG PRIOK,369,4,365,290,17,273,236,83,33,24,96
2020-05-15,TEBET,194,2,192,105,6,99,109,25,41,11,32
2020-05-16,BELUM DIKETAHUI,2645,4,2641,2036,25,2011,315,133,36,5,141
2020-05-16,CAKUNG,245,3,242,95,12,83,113,39,24,9,41
2020-05-16,CEMPAKA PUTIH,338,4,334,170,8,162,84,29,20,7,28
2020-05-16,CENGKARENG,193,1,192,69,2,67,115,43,20,8,44
2020-05-16,CILANDAK,235,6,229,152,37,115,88,21,33,14,20
2020-05-16,CILINCING,392,8,384,66,12,54,64,27,3,7,27
2020-05-16,CIPAYUNG,124,7,117,73,13,60,62,24,16,1,21
2020-05-16,CIRACAS,199,5,194,68,6,62,48,14,11,8,15
2020-05-16,DUREN SAWIT,219,5,214,104,7,97,195,45,54,25,71
2020-05-16,GAMBIR,186,1,185,61,5,56,49,20,8,7,14
2020-05-16,GROGOL PETAMBURAN,304,2,302,139,8,131,137,39,56,12,30
2020-05-16,JAGAKARSA,317,9,308,123,25,98,79,20,28,7,24
2020-05-16,JATINEGARA,255,2,253,45,6,39,120,39,29,11,41
2020-05-16,JOHAR BARU,207,3,204,59,13,46,56,12,9,10,25
2020-05-16,KALI DERES,327,0,327,175,3,172,112,32,43,9,28
2020-05-16,KEBAYORAN BARU,116,2,114,89,13,76,70,12,43,3,12
2020-05-16,KEBAYORAN LAMA,177,3,174,140,31,109,124,35,37,18,34
2020-05-16,KEBON JERUK,534,3,531,154,17,137,170,53,47,13,57
2020-05-16,KELAPA GADING,303,1,302,111,9,102,112,33,30,8,41
2020-05-16,KEMAYORAN,252,5,247,140,12,128,106,24,19,13,50
2020-05-16,KEMBANGAN,126,1,125,97,7,90,111,32,31,5,43
2020-05-16,KEP. SERIBU SELATAN,91,0,91,5,0,5,13,3,0,0,10
2020-05-16,KEP. SERIBU UTARA,170,3,167,14,0,14,1,0,0,0,1
2020-05-16,KOJA,246,3,243,140,9,131,92,29,12,5,46
2020-05-16,KRAMAT JATI,99,2,97,45,3,42,103,30,22,10,41
2020-05-16,LUAR DKI JAKARTA,1999,45,1954,1125,94,1031,1108,450,265,67,326
2020-05-16,MAKASAR,65,2,63,38,4,34,59,24,16,7,12
2020-05-16,MAMPANG PRAPATAN,198,1,197,40,2,38,53,17,13,7,16
2020-05-16,MATRAMAN,335,6,329,104,10,94,115,36,19,10,50
2020-05-16,MENTENG,101,9,92,54,12,42,67,27,10,9,21
2020-05-16,PADEMANGAN,329,2,327,72,6,66,136,35,9,7,85
2020-05-16,PALMERAH,314,2,312,216,21,195,126,41,27,13,45
2020-05-16,PANCORAN,121,3,118,55,3,52,56,27,10,3,16
2020-05-16,PASAR MINGGU,365,10,355,132,25,107,106,38,25,13,30
2020-05-16,PASAR REBO,97,4,93,34,1,33,47,10,10,4,23
2020-05-16,PENJARINGAN,412,0,412,82,4,78,123,30,25,8,60
2020-05-16,PESANGGRAHAN,167,9,158,89,15,74,77,22,21,15,19
2020-05-16,PULO GADUNG,273,3,270,114,13,101,124,44,37,11,32
2020-05-16,SAWAH BESAR,188,2,186,177,15,162,82,43,14,7,18
2020-05-16,SENEN,233,2,231,74,8,66,80,22,16,4,38
2020-05-16,SETIA BUDI,175,3,172,60,6,54,60,20,18,9,13
2020-05-16,TAMAN SARI,102,1,101,49,4,45,86,36,17,5,28
2020-05-16,TAMBORA,127,1,126,75,13,62,77,22,6,9,40
2020-05-16,TANAH ABANG,528,1,527,171,11,160,299,65,29,17,188
2020-05-16,TANJUNG PRIOK,390,6,384,294,18,276,260,85,33,24,118
2020-05-16,TEBET,206,3,203,106,7,99,115,26,41,11,37
2020-05-17,BELUM DIKETAHUI,2646,4,2642,2036,25,2011,393,148,36,5,204
2020-05-17,CAKUNG,262,3,259,95,12,83,114,40,24,9,41
2020-05-17,CEMPAKA PUTIH,365,4,361,170,8,162,85,30,20,7,28
2020-05-17,CENGKARENG,294,2,292,69,2,67,117,44,20,8,45
2020-05-17,CILANDAK,273,6,267,152,37,115,88,21,33,14,20
2020-05-17,CILINCING,406,8,398,66,12,54,65,28,3,7,27
2020-05-17,CIPAYUNG,139,7,132,74,13,61,62,24,16,1,21
2020-05-17,CIRACAS,212,5,207,68,6,62,49,15,11,8,15
2020-05-17,DUREN SAWIT,257,5,252,104,7,97,197,47,55,25,70
2020-05-17,GAMBIR,198,1,197,61,5,56,47,19,8,6,14
2020-05-17,GROGOL PETAMBURAN,375,2,373,139,8,131,138,39,56,12,31
2020-05-17,JAGAKARSA,353,9,344,123,25,98,79,20,28,7,24
2020-05-17,JATINEGARA,281,2,279,45,6,39,123,39,29,11,44
2020-05-17,JOHAR BARU,234,3,231,59,13,46,56,12,9,10,25
2020-05-17,KALI DERES,367,0,367,175,3,172,115,33,43,11,28
2020-05-17,KEBAYORAN BARU,135,2,133,89,13,76,70,12,43,3,12
2020-05-17,KEBAYORAN LAMA,246,3,243,142,33,109,124,35,37,18,34
2020-05-17,KEBON JERUK,717,3,714,155,18,137,170,53,47,13,57
2020-05-17,KELAPA GADING,405,1,404,111,9,102,111,33,31,8,39
2020-05-17,KEMAYORAN,277,5,272,140,12,128,109,24,19,14,52
2020-05-17,KEMBANGAN,159,1,158,98,8,90,111,32,31,5,43
2020-05-17,KEP. SERIBU SELATAN,114,0,114,5,0,5,13,3,0,0,10
2020-05-17,KEP. SERIBU UTARA,215,3,212,14,0,14,1,0,0,0,1
2020-05-17,KOJA,280,3,277,140,9,131,93,30,12,5,46
2020-05-17,KRAMAT JATI,118,2,116,45,3,42,104,31,22,10,41
2020-05-17,LUAR DKI JAKARTA,2531,53,2478,1129,98,1031,1109,448,265,67,329
2020-05-17,MAKASAR,75,2,73,38,4,34,60,24,17,7,12
2020-05-17,MAMPANG PRAPATAN,221,1,220,40,2,38,53,17,13,7,16
2020-05-17,MATRAMAN,508,6,502,107,10,97,115,35,19,10,51
2020-05-17,MENTENG,107,9,98,54,12,42,67,27,10,9,21
2020-05-17,PADEMANGAN,345,2,343,73,7,66,143,35,9,7,92
2020-05-17,PALMERAH,331,3,328,217,22,195,126,41,27,13,45
2020-05-17,PANCORAN,208,3,205,56,3,53,56,27,10,3,16
2020-05-17,PASAR MINGGU,395,10,385,133,25,108,107,38,25,13,31
2020-05-17,PASAR REBO,122,4,118,35,1,34,47,10,10,4,23
2020-05-17,PENJARINGAN,434,0,434,82,4,78,125,30,25,9,61
2020-05-17,PESANGGRAHAN,174,9,165,90,16,74,77,22,21,15,19
2020-05-17,PULO GADUNG,298,3,295,115,13,102,124,44,37,11,32
2020-05-17,SAWAH BESAR,220,2,218,177,15,162,83,44,14,7,18
2020-05-17,SENEN,347,2,345,74,8,66,94,23,16,4,51
2020-05-17,SETIA BUDI,184,3,181,60,6,54,60,20,18,9,13
2020-05-17,TAMAN SARI,116,1,115,49,4,45,87,36,17,5,29
2020-05-17,TAMBORA,155,2,153,75,13,62,77,22,6,9,40
2020-05-17,TANAH ABANG,563,1,562,171,11,160,299,65,29,17,188
2020-05-17,TANJUNG PRIOK,523,6,517,299,18,281,262,86,33,24,119
2020-05-17,TEBET,223,3,220,106,7,99,117,26,41,11,39
2020-05-18,BELUM DIKETAHUI,2650,4,2646,2036,17,2019,381,154,36,7,184
2020-05-18,CAKUNG,294,6,288,98,12,86,114,40,24,9,41
2020-05-18,CEMPAKA PUTIH,428,5,423,175,10,165,85,30,20,7,28
2020-05-18,CENGKARENG,329,2,327,70,2,68,119,44,20,8,47
2020-05-18,CILANDAK,309,5,304,154,24,130,88,21,33,14,20
2020-05-18,CILINCING,474,9,465,74,17,57,65,28,3,7,27
2020-05-18,CIPAYUNG,172,7,165,74,10,64,62,24,16,1,21
2020-05-18,CIRACAS,230,4,226,71,9,62,48,14,11,8,15
2020-05-18,DUREN SAWIT,284,5,279,105,5,100,223,48,55,25,95
2020-05-18,GAMBIR,229,0,229,62,5,57,47,19,8,6,14
2020-05-18,GROGOL PETAMBURAN,399,2,397,139,6,133,139,38,58,12,31
2020-05-18,JAGAKARSA,433,8,425,123,18,105,80,21,28,7,24
2020-05-18,JATINEGARA,304,2,302,45,5,40,125,41,29,11,44
2020-05-18,JOHAR BARU,263,4,259,65,19,46,57,12,9,11,25
2020-05-18,KALI DERES,444,0,444,176,2,174,116,34,43,11,28
2020-05-18,KEBAYORAN BARU,160,2,158,91,11,80,70,12,43,3,12
2020-05-18,KEBAYORAN LAMA,330,3,327,142,27,115,124,34,37,18,35
2020-05-18,KEBON JERUK,819,3,816,155,15,140,169,53,47,13,56
2020-05-18,KELAPA GADING,470,1,469,112,9,103,111,33,31,8,39
2020-05-18,KEMAYORAN,303,7,296,147,16,131,111,25,19,14,53
2020-05-18,KEMBANGAN,183,1,182,98,8,90,111,32,31,5,43
2020-05-18,KEP. SERIBU SELATAN,117,1,116,5,0,5,13,3,0,0,10
2020-05-18,KEP. SERIBU UTARA,221,2,219,14,0,14,1,0,0,0,1
2020-05-18,KOJA,412,2,410,143,7,136,95,29,12,5,49
2020-05-18,KRAMAT JATI,161,1,160,45,3,42,112,34,22,10,46
2020-05-18,LUAR DKI JAKARTA,3015,56,2959,1141,90,1051,1119,448,265,67,339
2020-05-18,MAKASAR,86,1,85,38,4,34,60,24,17,7,12
2020-05-18,MAMPANG PRAPATAN,262,1,261,40,0,40,53,17,13,7,16
2020-05-18,MATRAMAN,563,6,557,109,8,101,116,36,19,10,51
2020-05-18,MENTENG,136,8,128,54,11,43,66,27,10,9,20
2020-05-18,PADEMANGAN,364,2,362,73,6,67,145,35,9,7,94
2020-05-18,PALMERAH,352,3,349,217,19,198,132,42,28,13,49
2020-05-18,PANCORAN,269,3,266,56,0,56,57,27,11,3,16
2020-05-18,PASAR MINGGU,441,9,432,133,12,121,107,37,25,14,31
2020-05-18,PASAR REBO,139,4,135,36,2,34,48,10,10,4,24
2020-05-18,PENJARINGAN,447,0,447,82,4,78,127,30,25,9,63
2020-05-18,PESANGGRAHAN,198,10,188,91,16,75,78,23,21,15,19
2020-05-18,PULO GADUNG,328,3,325,117,10,107,124,42,39,11,32
2020-05-18,SAWAH BESAR,223,2,221,177,13,164,84,45,14,7,18
2020-05-18,SENEN,462,2,460,75,8,67,94,24,16,4,50
2020-05-18,SETIA BUDI,205,3,202,60,4,56,60,20,18,9,13
2020-05-18,TAMAN SARI,130,1,129,49,3,46,91,36,17,5,33
2020-05-18,TAMBORA,179,2,177,75,12,63,80,22,6,9,43
2020-05-18,TANAH ABANG,619,2,617,171,9,162,305,65,29,17,194
2020-05-18,TANJUNG PRIOK,787,4,783,302,14,288,266,86,33,25,122
2020-05-18,TEBET,249,3,246,106,5,101,118,27,41,11,39
2020-05-19,BELUM DIKETAHUI,2666,4,2662,2049,18,2031,329,123,33,7,166
2020-05-19,CAKUNG,320,6,314,103,14,89,114,40,26,9,39
2020-05-19,CEMPAKA PUTIH,460,5,455,176,10,166,87,31,20,7,29
2020-05-19,CENGKARENG,362,2,360,72,3,69,120,45,21,8,46
2020-05-19,CILANDAK,383,5,378,168,27,141,89,21,33,14,21
2020-05-19,CILINCING,513,10,503,74,17,57,65,27,3,8,27
2020-05-19,CIPAYUNG,220,8,212,78,10,68,64,25,16,1,22
2020-05-19,CIRACAS,251,4,247,77,9,68,52,14,13,8,17
2020-05-19,DUREN SAWIT,326,5,321,106,6,100,224,48,57,25,94
2020-05-19,GAMBIR,232,0,232,62,5,57,48,19,10,6,13
2020-05-19,GROGOL PETAMBURAN,407,2,405,139,6,133,143,40,61,12,30
2020-05-19,JAGAKARSA,493,9,484,141,21,120,83,22,30,7,24
2020-05-19,JATINEGARA,322,2,320,52,8,44,125,41,35,11,38
2020-05-19,JOHAR BARU,299,4,295,65,19,46,57,11,9,11,26
2020-05-19,KALI DERES,470,1,469,180,5,175,116,34,47,11,24
2020-05-19,KEBAYORAN BARU,182,3,179,95,11,84,68,12,42,3,11
2020-05-19,KEBAYORAN LAMA,397,3,394,153,30,123,125,33,38,18,36
2020-05-19,KEBON JERUK,832,4,828,161,17,144,171,56,53,13,49
2020-05-19,KELAPA GADING,525,1,524,115,12,103,113,33,36,8,36
2020-05-19,KEMAYORAN,332,7,325,152,20,132,112,23,21,14,54
2020-05-19,KEMBANGAN,203,1,202,103,12,91,113,32,31,5,45
2020-05-19,KEP. SERIBU SELATAN,119,1,118,5,0,5,13,3,0,0,10
2020-05-19,KEP. SERIBU UTARA,221,2,219,14,0,14,1,0,0,0,1
2020-05-19,KOJA,464,2,462,145,9,136,97,30,13,5,49
2020-05-19,KRAMAT JATI,271,1,270,50,5,45,115,34,26,10,45
2020-05-19,LUAR DKI JAKARTA,3538,62,3476,1217,106,1111,1156,467,297,68,324
2020-05-19,MAKASAR,97,1,96,40,4,36,61,24,18,7,12
2020-05-19,MAMPANG PRAPATAN,298,1,297,45,1,44,54,18,15,7,14
2020-05-19,MATRAMAN,586,6,580,111,8,103,120,38,22,10,50
2020-05-19,MENTENG,148,9,139,55,12,43,67,27,11,9,20
2020-05-19,PADEMANGAN,386,2,384,73,6,67,154,35,9,7,103
2020-05-19,PALMERAH,363,5,358,217,19,198,139,34,46,13,46
2020-05-19,PANCORAN,313,4,309,65,2,63,57,27,11,3,16
2020-05-19,PASAR MINGGU,496,10,486,162,17,145,109,38,27,14,30
2020-05-19,PASAR REBO,167,4,163,44,7,37,48,10,11,4,23
2020-05-19,PENJARINGAN,451,0,451,85,6,79,129,32,27,9,61
2020-05-19,PESANGGRAHAN,249,10,239,98,18,80,79,24,23,15,17
2020-05-19,PULO GADUNG,360,3,357,120,10,110,129,43,45,11,30
2020-05-19,SAWAH BESAR,227,2,225,177,13,164,85,46,14,7,18
2020-05-19,SENEN,489,2,487,77,9,68,98,24,17,4,53
2020-05-19,SETIA BUDI,215,3,212,62,5,57,60,20,18,9,13
2020-05-19,TAMAN SARI,146,1,145,49,3,46,94,35,17,5,37
2020-05-19,TAMBORA,183,2,181,75,12,63,84,23,6,11,44
2020-05-19,TANAH ABANG,677,2,675,172,9,163,309,66,29,17,197
2020-05-19,TANJUNG PRIOK,811,4,807,308,16,292,258,81,33,25,119
2020-05-19,TEBET,273,3,270,112,8,104,119,27,47,11,34
2020-05-20,BELUM DIKETAHUI,2549,2,2547,1996,13,1983,377,135,32,4,206
2020-05-20,CAKUNG,337,5,332,103,13,90,116,42,26,9,39
2020-05-20,CEMPAKA PUTIH,484,3,481,177,10,167,87,31,20,7,29
2020-05-20,CENGKARENG,379,2,377,77,7,70,121,45,21,8,47
2020-05-20,CILANDAK,400,2,398,168,25,143,89,21,33,14,21
2020-05-20,CILINCING,542,11,531,83,23,60,68,29,3,8,28
2020-05-20,CIPAYUNG,255,8,247,80,11,69,66,26,17,1,22
2020-05-20,CIRACAS,281,3,278,79,8,71,54,16,13,8,17
2020-05-20,DUREN SAWIT,455,5,450,111,5,106,231,47,58,25,101
2020-05-20,GAMBIR,244,0,244,62,5,57,48,19,10,6,13
2020-05-20,GROGOL PETAMBURAN,414,2,412,141,6,135,144,42,60,12,30
2020-05-20,JAGAKARSA,523,11,512,144,18,126,84,23,30,7,24
2020-05-20,JATINEGARA,351,3,348,52,8,44,129,39,35,13,42
2020-05-20,JOHAR BARU,317,4,313,65,18,47,59,14,9,11,25
2020-05-20,KALI DERES,487,1,486,181,6,175,117,35,48,11,23
2020-05-20,KEBAYORAN BARU,191,2,189,95,10,85,69,13,42,3,11
2020-05-20,KEBAYORAN LAMA,410,3,407,153,26,127,126,34,38,18,36
2020-05-20,KEBON JERUK,858,5,853,163,18,145,171,55,53,14,49
2020-05-20,KELAPA GADING,556,1,555,124,11,113,115,34,37,8,36
2020-05-20,KEMAYORAN,347,6,341,152,20,132,112,22,23,14,53
2020-05-20,KEMBANGAN,210,3,207,106,14,92,113,32,31,5,45
2020-05-20,KEP. SERIBU SELATAN,119,1,118,5,0,5,13,3,0,0,10
2020-05-20,KEP. SERIBU UTARA,224,1,223,14,0,14,1,0,0,0,1
2020-05-20,KOJA,501,2,499,147,7,140,99,32,13,6,48
2020-05-20,KRAMAT JATI,286,1,285,51,5,46,117,36,26,10,45
2020-05-20,LUAR DKI JAKARTA,3859,82,3777,1239,114,1125,1159,470,296,71,322
2020-05-20,MAKASAR,118,1,117,43,5,38,61,24,18,7,12
2020-05-20,MAMPANG PRAPATAN,320,0,320,45,1,44,54,18,15,7,14
2020-05-20,MATRAMAN,590,5,585,111,7,104,121,38,22,11,50
2020-05-20,MENTENG,164,9,155,55,9,46,68,28,11,9,20
2020-05-20,PADEMANGAN,474,0,474,77,6,71,154,35,9,8,102
2020-05-20,PALMERAH,384,10,374,221,22,199,139,34,46,13,46
2020-05-20,PANCORAN,334,3,331,65,1,64,57,27,11,3,16
2020-05-20,PASAR MINGGU,521,8,513,164,15,149,109,37,28,14,30
2020-05-20,PASAR REBO,175,4,171,44,6,38,47,10,11,4,22
2020-05-20,PENJARINGAN,458,0,458,86,6,80,130,32,28,9,61
2020-05-20,PESANGGRAHAN,265,8,257,98,17,81,78,24,22,15,17
2020-05-20,PULO GADUNG,371,3,368,120,10,110,131,44,45,11,31
2020-05-20,SAWAH BESAR,231,2,229,179,15,164,86,46,14,8,18
2020-05-20,SENEN,499,2,497,79,8,71,101,24,18,4,55
2020-05-20,SETIA BUDI,224,1,223,63,4,59,61,19,19,9,14
2020-05-20,TAMAN SARI,158,1,157,51,5,46,94,35,17,5,37
2020-05-20,TAMBORA,188,2,186,77,13,64,86,23,6,10,47
2020-05-20,TANAH ABANG,716,3,713,175,11,164,309,66,30,17,196
2020-05-20,TANJUNG PRIOK,845,3,842,309,15,294,259,82,34,25,118
2020-05-20,TEBET,339,6,333,112,8,104,120,28,47,11,34
2020-05-21,BELUM DIKETAHUI,2535,2,2533,1997,13,1984,348,145,31,7,165
2020-05-21,CAKUNG,344,5,339,103,13,90,117,41,27,9,40
2020-05-21,CEMPAKA PUTIH,607,5,602,180,11,169,88,31,20,7,30
2020-05-21,CENGKARENG,414,2,412,79,9,70,121,42,24,9,46
2020-05-21,CILANDAK,421,2,419,169,25,144,89,21,34,14,20
2020-05-21,CILINCING,553,11,542,85,24,61,68,29,3,8,28
2020-05-21,CIPAYUNG,271,8,263,81,11,70,67,26,17,1,23
2020-05-21,CIRACAS,285,3,282,79,8,71,55,17,13,8,17
2020-05-21,DUREN SAWIT,526,6,520,119,6,113,234,48,65,25,96
2020-05-21,GAMBIR,250,0,250,63,6,57,48,19,10,6,13
2020-05-21,GROGOL PETAMBURAN,458,2,456,144,7,137,144,42,60,12,30
2020-05-21,JAGAKARSA,528,11,517,145,19,126,84,23,30,7,24
2020-05-21,JATINEGARA,354,3,351,53,8,45,131,39,37,13,42
2020-05-21,JOHAR BARU,346,4,342,65,18,47,61,14,9,11,27
2020-05-21,KALI DERES,502,1,501,182,6,176,117,34,55,11,17
2020-05-21,KEBAYORAN BARU,193,2,191,97,11,86,69,12,43,3,11
2020-05-21,KEBAYORAN LAMA,413,3,410,154,27,127,126,34,43,18,31
2020-05-21,KEBON JERUK,882,5,877,165,19,146,176,55,57,14,50
2020-05-21,KELAPA GADING,567,1,566,130,11,119,116,34,37,9,36
2020-05-21,KEMAYORAN,354,7,347,154,21,133,114,22,24,14,54
2020-05-21,KEMBANGAN,219,3,216,108,14,94,114,32,32,5,45
2020-05-21,KEP. SERIBU SELATAN,124,1,123,5,0,5,13,3,0,0,10
2020-05-21,KEP. SERIBU UTARA,224,1,223,14,0,14,1,0,0,0,1
2020-05-21,KOJA,516,2,514,150,8,142,99,33,13,6,47
2020-05-21,KRAMAT JATI,289,1,288,57,8,49,118,36,28,10,44
2020-05-21,LUAR DKI JAKARTA,4017,88,3929,1259,126,1133,1206,461,329,71,345
2020-05-21,MAKASAR,122,1,121,43,5,38,62,17,27,7,11
2020-05-21,MAMPANG PRAPATAN,322,0,322,47,3,44,55,16,17,7,15
2020-05-21,MATRAMAN,595,7,588,111,7,104,123,40,29,11,43
2020-05-21,MENTENG,173,9,164,55,9,46,69,29,13,9,18
2020-05-21,PADEMANGAN,478,1,477,84,12,72,155,35,9,8,103
2020-05-21,PALMERAH,409,10,399,222,22,200,139,34,47,13,45
2020-05-21,PANCORAN,339,3,336,65,1,64,57,25,14,3,15
2020-05-21,PASAR MINGGU,523,8,515,165,15,150,109,35,30,14,30
2020-05-21,PASAR REBO,177,5,172,45,6,39,48,11,12,4,21
2020-05-21,PENJARINGAN,463,0,463,92,12,80,131,32,29,9,61
2020-05-21,PESANGGRAHAN,268,8,260,98,17,81,78,23,23,15,17
2020-05-21,PULO GADUNG,382,5,377,122,12,110,131,42,48,11,30
2020-05-21,SAWAH BESAR,239,2,237,184,20,164,88,44,17,8,19
2020-05-21,SENEN,506,2,504,81,9,72,101,25,20,4,52
2020-05-21,SETIA BUDI,229,1,228,65,6,59,61,19,20,9,13
2020-05-21,TAMAN SARI,173,3,170,55,9,46,96,35,17,5,39
2020-05-21,TAMBORA,197,3,194,84,18,66,96,24,6,10,56
2020-05-21,TANAH ABANG,724,3,721,178,13,165,314,66,32,17,199
2020-05-21,TANJUNG PRIOK,852,3,849,314,18,296,262,81,36,25,120
2020-05-21,TEBET,346,7,339,114,8,106,121,29,49,11,32
2020-05-22,BELUM DIKETAHUI,2548,2,2546,1998,13,1985,386,149,32,9,196
2020-05-22,CAKUNG,344,5,339,103,13,90,117,41,28,9,39
2020-05-22,CEMPAKA PUTIH,609,5,604,180,11,169,88,31,20,7,30
2020-05-22,CENGKARENG,415,2,413,79,9,70,121,42,24,10,45
2020-05-22,CILANDAK,422,2,420,169,25,144,89,21,36,14,18
2020-05-22,CILINCING,596,11,585,85,24,61,69,29,3,8,29
2020-05-22,CIPAYUNG,274,8,266,81,11,70,67,26,17,1,23
2020-05-22,CIRACAS,304,3,301,79,8,71,55,17,13,8,17
2020-05-22,DUREN SAWIT,542,6,536,119,6,113,236,48,66,25,97
2020-05-22,GAMBIR,253,0,253,63,6,57,48,19,10,6,13
2020-05-22,GROGOL PETAMBURAN,461,2,459,144,7,137,147,43,60,12,32
2020-05-22,JAGAKARSA,526,11,515,145,19,126,84,23,30,7,24
2020-05-22,JATINEGARA,354,3,351,53,8,45,131,39,38,13,41
2020-05-22,JOHAR BARU,351,4,347,65,18,47,63,14,9,11,29
2020-05-22,KALI DERES,504,1,503,182,6,176,117,34,55,11,17
2020-05-22,KEBAYORAN BARU,194,2,192,97,11,86,69,12,43,3,11
2020-05-22,KEBAYORAN LAMA,415,3,412,154,27,127,127,34,43,18,32
2020-05-22,KEBON JERUK,894,5,889,165,19,146,177,56,57,14,50
2020-05-22,KELAPA GADING,573,1,572,130,11,119,116,34,37,9,36
2020-05-22,KEMAYORAN,356,7,349,154,21,133,114,22,24,14,54
2020-05-22,KEMBANGAN,219,3,216,108,14,94,114,32,32,5,45
2020-05-22,KEP. SERIBU SELATAN,136,1,135,5,0,5,13,3,0,0,10
2020-05-22,KEP. SERIBU UTARA,224,1,223,14,0,14,1,0,0,0,1
2020-05-22,KOJA,520,2,518,151,8,143,107,34,14,6,53
2020-05-22,KRAMAT JATI,312,1,311,57,8,49,118,36,29,10,43
2020-05-22,LUAR DKI JAKARTA,4059,88,3971,1261,127,1134,1218,469,339,71,339
2020-05-22,MAKASAR,127,1,126,43,5,38,63,17,28,7,11
2020-05-22,MAMPANG PRAPATAN,327,0,327,47,3,44,55,16,19,7,13
2020-05-22,MATRAMAN,608,7,601,111,7,104,123,40,29,11,43
2020-05-22,MENTENG,174,9,165,55,9,46,67,28,13,8,18
2020-05-22,PADEMANGAN,478,1,477,84,12,72,158,35,9,8,106
2020-05-22,PALMERAH,420,10,410,222,22,200,146,38,47,14,47
2020-05-22,PANCORAN,345,3,342,65,1,64,57,25,15,3,14
2020-05-22,PASAR MINGGU,560,8,552,164,15,149,109,35,30,14,30
2020-05-22,PASAR REBO,181,5,176,46,6,40,48,11,12,4,21
2020-05-22,PENJARINGAN,540,0,540,92,12,80,136,34,29,9,64
2020-05-22,PESANGGRAHAN,269,8,261,98,17,81,78,23,23,15,17
2020-05-22,PULO GADUNG,383,5,378,122,12,110,131,42,49,11,29
2020-05-22,SAWAH BESAR,239,2,237,184,20,164,88,43,17,8,20
2020-05-22,SENEN,508,2,506,81,9,72,102,25,20,4,53
2020-05-22,SETIA BUDI,230,1,229,65,6,59,65,20,20,9,16
2020-05-22,TAMAN SARI,174,3,171,55,9,46,102,35,17,5,45
2020-05-22,TAMBORA,254,3,251,84,18,66,98,24,6,10,58
2020-05-22,TANAH ABANG,724,3,721,178,13,165,317,67,33,17,200
2020-05-22,TANJUNG PRIOK,853,3,850,314,18,296,262,81,36,25,120
2020-05-22,TEBET,346,7,339,114,8,106,119,28,47,11,33
2020-05-23,BELUM DIKETAHUI,2725,4,2721,1998,14,1984,383,118,31,8,226
2020-05-23,CAKUNG,355,5,350,106,16,90,118,42,28,9,39
2020-05-23,CEMPAKA PUTIH,638,6,632,182,11,171,89,31,20,7,31
2020-05-23,CENGKARENG,477,4,473,81,11,70,126,43,25,10,48
2020-05-23,CILANDAK,438,2,436,175,30,145,89,21,36,14,18
2020-05-23,CILINCING,661,20,641,89,28,61,71,30,4,8,29
2020-05-23,CIPAYUNG,298,10,288,83,12,71,69,28,17,1,23
2020-05-23,CIRACAS,329,5,324,80,9,71,57,19,13,8,17
2020-05-23,DUREN SAWIT,606,7,599,125,6,119,241,52,69,25,95
2020-05-23,GAMBIR,270,2,268,63,6,57,48,19,10,6,13
2020-05-23,GROGOL PETAMBURAN,488,3,485,145,8,137,149,44,61,13,31
2020-05-23,JAGAKARSA,557,14,543,151,24,127,88,25,30,7,26
2020-05-23,JATINEGARA,364,4,360,53,8,45,132,40,38,13,41
2020-05-23,JOHAR BARU,367,5,362,67,20,47,65,16,9,11,29
2020-05-23,KALI DERES,521,1,520,185,7,178,118,35,56,11,16
2020-05-23,KEBAYORAN BARU,203,3,200,106,17,89,69,12,44,3,10
2020-05-23,KEBAYORAN LAMA,435,4,431,163,31,132,128,35,43,18,32
2020-05-23,KEBON JERUK,974,10,964,175,28,147,179,57,57,14,51
2020-05-23,KELAPA GADING,588,1,587,139,11,128,117,34,38,9,36
2020-05-23,KEMAYORAN,388,8,380,155,22,133,114,22,24,14,54
2020-05-23,KEMBANGAN,254,5,249,109,15,94,114,32,34,5,43
2020-05-23,KEP. SERIBU SELATAN,144,1,143,5,0,5,13,3,0,0,10
2020-05-23,KEP. SERIBU UTARA,224,1,223,14,0,14,1,0,0,0,1
2020-05-23,KOJA,549,8,541,156,8,148,109,35,16,7,51
2020-05-23,KRAMAT JATI,324,2,322,61,12,49,119,37,30,10,42
2020-05-23,LUAR DKI JAKARTA,4275,117,4158,1296,155,1141,1259,494,349,71,345
2020-05-23,MAKASAR,143,4,139,46,7,39,64,18,28,7,11
2020-05-23,MAMPANG PRAPATAN,332,1,331,48,4,44,58,17,19,7,15
2020-05-23,MATRAMAN,623,8,615,111,7,104,124,41,29,11,43
2020-05-23,MENTENG,196,10,186,56,10,46,68,29,13,8,18
2020-05-23,PADEMANGAN,514,10,504,90,18,72,167,37,9,8,113
2020-05-23,PALMERAH,509,14,495,228,28,200,147,38,47,14,48
2020-05-23,PANCORAN,361,4,357,69,4,65,58,26,15,3,14
2020-05-23,PASAR MINGGU,585,12,573,167,17,150,109,35,30,14,30
2020-05-23,PASAR REBO,200,6,194,48,6,42,49,12,14,4,19
2020-05-23,PENJARINGAN,577,1,576,95,12,83,144,35,29,10,70
2020-05-23,PESANGGRAHAN,294,9,285,100,19,81,79,24,26,15,14
2020-05-23,PULO GADUNG,409,7,402,123,13,110,131,42,50,11,28
2020-05-23,SAWAH BESAR,250,4,246,186,22,164,90,43,17,8,22
2020-05-23,SENEN,518,3,515,82,10,72,103,26,20,4,53
2020-05-23,SETIA BUDI,239,4,235,69,10,59,67,21,20,9,17
2020-05-23,TAMAN SARI,182,4,178,57,11,46,102,35,17,5,45
2020-05-23,TAMBORA,276,3,273,87,21,66,98,24,6,10,58
2020-05-23,TANAH ABANG,803,8,795,190,24,166,333,68,33,17,215
2020-05-23,TANJUNG PRIOK,880,8,872,319,22,297,267,82,36,26,123
2020-05-23,TEBET,356,10,346,116,10,106,120,29,47,11,33
2020-05-24,BELUM DIKETAHUI,3154,97,3057,2219,153,2066,430,139,31,9,251
2020-05-24,CAKUNG,356,5,351,106,7,99,121,42,28,9,42
2020-05-24,CEMPAKA PUTIH,641,3,638,182,9,173,90,31,23,7,29
2020-05-24,CENGKARENG,480,1,479,81,8,73,130,44,25,10,51
2020-05-24,CILANDAK,440,1,439,175,16,159,89,21,36,14,18
2020-05-24,CILINCING,667,10,657,89,16,73,71,30,4,8,29
2020-05-24,CIPAYUNG,303,6,297,83,7,76,69,28,17,1,23
2020-05-24,CIRACAS,335,3,332,81,4,77,58,18,14,8,18
2020-05-24,DUREN SAWIT,610,4,606,125,5,120,242,52,69,25,96
2020-05-24,GAMBIR,271,2,269,63,4,59,48,19,10,6,13
2020-05-24,GROGOL PETAMBURAN,499,2,497,145,8,137,151,45,61,13,32
2020-05-24,JAGAKARSA,558,5,553,151,10,141,87,25,30,7,25
2020-05-24,JATINEGARA,366,2,364,53,4,49,132,40,38,13,41
2020-05-24,JOHAR BARU,368,3,365,67,10,57,66,17,9,11,29
2020-05-24,KALI DERES,523,0,523,185,4,181,118,35,56,11,16
2020-05-24,KEBAYORAN BARU,206,1,205,106,6,100,69,12,44,3,10
2020-05-24,KEBAYORAN LAMA,437,2,435,163,9,154,128,35,43,18,32
2020-05-24,KEBON JERUK,991,5,986,175,19,156,181,58,57,14,52
2020-05-24,KELAPA GADING,588,0,588,139,8,131,117,34,38,9,36
2020-05-24,KEMAYORAN,390,5,385,155,15,140,117,22,24,14,57
2020-05-24,KEMBANGAN,263,3,260,110,11,99,124,32,34,5,53
2020-05-24,KEP. SERIBU SELATAN,144,1,143,5,0,5,13,3,0,0,10
2020-05-24,KEP. SERIBU UTARA,224,0,224,14,0,14,1,0,0,0,1
2020-05-24,KOJA,559,3,556,158,3,155,112,34,17,7,54
2020-05-24,KRAMAT JATI,327,1,326,63,9,54,120,37,30,10,43
2020-05-24,LUAR DKI JAKARTA,4467,105,4362,1369,131,1238,1256,489,349,71,347
2020-05-24,MAKASAR,150,1,149,46,5,41,65,19,28,7,11
2020-05-24,MAMPANG PRAPATAN,336,1,335,48,2,46,56,16,19,7,14
2020-05-24,MATRAMAN,634,6,628,111,7,104,124,41,29,11,43
2020-05-24,MENTENG,196,7,189,56,8,48,68,29,13,8,18
2020-05-24,PADEMANGAN,514,2,512,90,11,79,173,37,10,8,118
2020-05-24,PALMERAH,528,9,519,230,21,209,153,42,47,14,50
2020-05-24,PANCORAN,368,1,367,69,0,69,59,26,15,3,15
2020-05-24,PASAR MINGGU,590,3,587,167,13,154,110,35,30,14,31
2020-05-24,PASAR REBO,203,3,200,48,2,46,52,12,14,4,22
2020-05-24,PENJARINGAN,584,0,584,95,10,85,161,35,29,10,87
2020-05-24,PESANGGRAHAN,296,1,295,100,1,99,79,24,26,15,14
2020-05-24,PULO GADUNG,414,3,411,123,6,117,132,42,50,11,29
2020-05-24,SAWAH BESAR,250,2,248,186,17,169,90,43,17,8,22
2020-05-24,SENEN,518,2,516,82,9,73,104,26,20,4,54
2020-05-24,SETIA BUDI,240,3,237,69,4,65,66,21,20,9,16
2020-05-24,TAMAN SARI,183,2,181,57,11,46,102,35,17,5,45
2020-05-24,TAMBORA,278,2,276,87,19,68,99,24,6,10,59
2020-05-24,TANAH ABANG,806,4,802,191,14,177,333,68,33,17,215
2020-05-24,TANJUNG PRIOK,883,3,880,320,14,306,272,82,37,26,127
2020-05-24,TEBET,360,4,356,116,8,108,123,32,47,11,33
2020-05-25,BELUM DIKETAHUI,3667,105,3562,2561,264,2297,441,142,31,8,260
2020-05-25,CAKUNG,356,5,351,106,7,99,121,41,28,9,43
2020-05-25,CEMPAKA PUTIH,643,3,640,182,6,176,91,32,30,7,22
2020-05-25,CENGKARENG,480,1,479,81,8,73,130,44,28,10,48
2020-05-25,CILANDAK,440,1,439,175,15,160,90,21,36,14,19
2020-05-25,CILINCING,667,9,658,89,15,74,89,29,6,8,46
2020-05-25,CIPAYUNG,304,5,299,83,6,77,69,27,17,1,24
2020-05-25,CIRACAS,336,3,333,81,3,78,59,18,15,8,18
2020-05-25,DUREN SAWIT,615,4,611,126,5,121,243,52,69,25,97
2020-05-25,GAMBIR,273,2,271,63,2,61,48,19,10,6,13
2020-05-25,GROGOL PETAMBURAN,505,2,503,145,7,138,151,45,61,13,32
2020-05-25,JAGAKARSA,558,1,557,151,9,142,88,26,30,7,25
2020-05-25,JATINEGARA,366,2,364,53,3,50,132,40,38,13,41
2020-05-25,JOHAR BARU,369,3,366,67,4,63,66,17,11,11,27
2020-05-25,KALI DERES,524,0,524,185,3,182,118,35,57,11,15
2020-05-25,KEBAYORAN BARU,206,1,205,106,4,102,69,12,44,3,10
2020-05-25,KEBAYORAN LAMA,439,2,437,163,8,155,129,36,44,18,31
2020-05-25,KEBON JERUK,996,4,992,177,18,159,181,58,59,15,49
2020-05-25,KELAPA GADING,589,0,589,139,5,134,118,34,43,9,32
2020-05-25,KEMAYORAN,391,5,386,155,10,145,118,23,26,14,55
2020-05-25,KEMBANGAN,265,3,262,110,11,99,124,32,36,5,51
2020-05-25,KEP. SERIBU SELATAN,144,1,143,5,0,5,13,3,0,0,10
2020-05-25,KEP. SERIBU UTARA,224,0,224,14,0,14,1,0,0,0,1
2020-05-25,KOJA,563,3,560,160,3,157,113,34,17,7,55
2020-05-25,KRAMAT JATI,330,1,329,63,9,54,125,38,33,11,43
2020-05-25,LUAR DKI JAKARTA,4676,78,4598,1449,144,1305,1271,492,357,71,351
2020-05-25,MAKASAR,152,1,151,46,4,42,65,19,29,7,10
2020-05-25,MAMPANG PRAPATAN,338,1,337,48,2,46,56,16,19,7,14
2020-05-25,MATRAMAN,634,6,628,111,6,105,124,41,31,11,41
2020-05-25,MENTENG,197,4,193,56,3,53,68,29,13,8,18
2020-05-25,PADEMANGAN,514,2,512,90,10,80,174,38,14,8,114
2020-05-25,PALMERAH,538,9,529,233,22,211,153,42,47,14,50
2020-05-25,PANCORAN,368,1,367,70,1,69,59,26,16,3,14
2020-05-25,PASAR MINGGU,590,2,588,167,9,158,111,36,30,14,31
2020-05-25,PASAR REBO,203,2,201,48,2,46,52,11,16,4,21
2020-05-25,PENJARINGAN,585,0,585,95,10,85,161,35,29,10,87
2020-05-25,PESANGGRAHAN,297,1,296,101,2,99,79,24,26,15,14
2020-05-25,PULO GADUNG,414,3,411,123,4,119,132,42,50,11,29
2020-05-25,SAWAH BESAR,250,2,248,186,11,175,91,44,20,8,19
2020-05-25,SENEN,519,2,517,82,3,79,104,26,21,4,53
2020-05-25,SETIA BUDI,240,3,237,69,4,65,67,24,20,9,14
2020-05-25,TAMAN SARI,184,2,182,57,9,48,102,35,17,5,45
2020-05-25,TAMBORA,282,2,280,87,18,69,101,24,6,10,61
2020-05-25,TANAH ABANG,807,4,803,192,12,180,333,68,33,17,215
2020-05-25,TANJUNG PRIOK,883,3,880,320,13,307,275,82,37,26,130
2020-05-25,TEBET,360,3,357,117,8,109,123,32,48,11,32
2020-05-26,BELUM DIKETAHUI,3769,116,3653,2608,272,2336,459,150,27,9,273
2020-05-26,CAKUNG,372,5,367,108,8,100,121,41,28,9,43
2020-05-26,CEMPAKA PUTIH,645,4,641,184,6,178,91,31,31,7,22
2020-05-26,CENGKARENG,484,1,483,83,8,75,130,43,30,10,47
2020-05-26,CILANDAK,446,1,445,176,15,161,90,20,37,14,19
2020-05-26,CILINCING,691,9,682,93,17,76,89,29,6,8,46
2020-05-26,CIPAYUNG,313,6,307,87,6,81,69,27,17,1,24
2020-05-26,CIRACAS,342,4,338,83,3,80,60,18,16,8,18
2020-05-26,DUREN SAWIT,625,6,619,133,6,127,243,52,70,25,96
2020-05-26,GAMBIR,282,2,280,63,2,61,48,19,11,6,12
2020-05-26,GROGOL PETAMBURAN,523,8,515,148,8,140,151,45,61,13,32
2020-05-26,JAGAKARSA,564,2,562,153,9,144,88,26,30,7,25
2020-05-26,JATINEGARA,367,2,365,58,4,54,136,39,39,13,45
2020-05-26,JOHAR BARU,377,3,374,69,4,65,66,17,11,11,27
2020-05-26,KALI DERES,528,0,528,187,3,184,121,34,58,11,18
2020-05-26,KEBAYORAN BARU,208,1,207,109,4,105,69,12,44,3,10
2020-05-26,KEBAYORAN LAMA,442,2,440,165,9,156,130,37,44,18,31
2020-05-26,KEBON JERUK,1004,4,1000,184,22,162,182,57,62,15,48
2020-05-26,KELAPA GADING,593,0,593,140,5,135,118,34,43,9,32
2020-05-26,KEMAYORAN,396,7,389,160,10,150,118,23,26,14,55
2020-05-26,KEMBANGAN,272,4,268,117,15,102,124,30,38,5,51
2020-05-26,KEP. SERIBU SELATAN,183,1,182,5,0,5,13,3,0,0,10
2020-05-26,KEP. SERIBU UTARA,224,0,224,14,0,14,1,0,0,0,1
2020-05-26,KOJA,587,5,582,167,3,164,113,34,19,7,53
2020-05-26,KRAMAT JATI,334,1,333,68,9,59,126,38,34,11,43
2020-05-26,LUAR DKI JAKARTA,5289,320,4969,1581,201,1380,1277,489,370,71,347
2020-05-26,MAKASAR,156,2,154,48,4,44,66,19,30,7,10
2020-05-26,MAMPANG PRAPATAN,340,1,339,48,2,46,56,16,19,7,14
2020-05-26,MATRAMAN,635,6,629,113,6,107,128,41,31,11,45
2020-05-26,MENTENG,197,4,193,57,3,54,68,29,13,8,18
2020-05-26,PADEMANGAN,516,3,513,94,11,83,173,38,13,8,114
2020-05-26,PALMERAH,547,11,536,236,24,212,167,43,47,14,63
2020-05-26,PANCORAN,372,1,371,70,1,69,59,26,16,3,14
2020-05-26,PASAR MINGGU,597,3,594,171,9,162,111,36,30,14,31
2020-05-26,PASAR REBO,219,2,217,51,2,49,53,11,16,4,22
2020-05-26,PENJARINGAN,593,1,592,95,10,85,161,35,30,10,86
2020-05-26,PESANGGRAHAN,299,1,298,106,3,103,79,24,26,15,14
2020-05-26,PULO GADUNG,415,3,412,124,5,119,133,42,51,11,29
2020-05-26,SAWAH BESAR,259,3,256,188,11,177,91,44,20,8,19
2020-05-26,SENEN,538,3,535,83,3,80,105,26,22,5,52
2020-05-26,SETIA BUDI,244,3,241,70,4,66,67,23,21,9,14
2020-05-26,TAMAN SARI,188,2,186,60,10,50,101,35,17,5,44
2020-05-26,TAMBORA,283,2,281,89,19,70,105,24,5,10,66
2020-05-26,TANAH ABANG,912,4,908,194,13,181,334,69,33,17,215
2020-05-26,TANJUNG PRIOK,893,3,890,325,13,312,275,82,38,26,129
2020-05-26,TEBET,366,3,363,117,8,109,124,33,48,11,32
2020-05-27,BELUM DIKETAHUI,3662,116,3546,2589,276,2313,531,137,27,11,356
2020-05-27,CAKUNG,388,5,383,109,8,101,122,40,28,9,45
2020-05-27,CEMPAKA PUTIH,691,5,686,187,6,181,90,31,31,7,21
2020-05-27,CENGKARENG,527,1,526,84,9,75,132,42,31,10,49
2020-05-27,CILANDAK,465,1,464,179,16,163,91,20,37,14,20
2020-05-27,CILINCING,711,19,692,92,17,75,88,29,6,8,45
2020-05-27,CIPAYUNG,321,7,314,92,10,82,69,27,17,1,24
2020-05-27,CIRACAS,359,5,354,84,3,81,60,18,16,8,18
2020-05-27,DUREN SAWIT,650,9,641,150,6,144,246,53,70,25,98
2020-05-27,GAMBIR,289,5,284,67,5,62,48,19,11,6,12
2020-05-27,GROGOL PETAMBURAN,561,10,551,150,10,140,151,44,62,13,32
2020-05-27,JAGAKARSA,597,5,592,154,9,145,88,25,31,7,25
2020-05-27,JATINEGARA,369,3,366,60,5,55,142,42,39,13,48
2020-05-27,JOHAR BARU,438,4,434,69,4,65,64,15,11,11,27
2020-05-27,KALI DERES,572,1,571,188,3,185,121,34,58,11,18
2020-05-27,KEBAYORAN BARU,212,1,211,109,5,104,70,12,44,3,11
2020-05-27,KEBAYORAN LAMA,450,4,446,168,12,156,131,38,44,18,31
2020-05-27,KEBON JERUK,1036,8,1028,188,26,162,183,58,62,15,48
2020-05-27,KELAPA GADING,613,0,613,143,6,137,118,34,43,9,32
2020-05-27,KEMAYORAN,412,12,400,163,13,150,120,24,26,14,56
2020-05-27,KEMBANGAN,290,10,280,120,17,103,125,31,38,5,51
2020-05-27,KEP. SERIBU SELATAN,187,1,186,5,0,5,13,3,0,0,10
2020-05-27,KEP. SERIBU UTARA,224,0,224,14,0,14,1,0,0,0,1
2020-05-27,KOJA,639,11,628,189,18,171,114,34,19,7,54
2020-05-27,KRAMAT JATI,359,5,354,78,18,60,129,38,34,11,46
2020-05-27,LUAR DKI JAKARTA,5554,358,5196,1610,216,1394,1299,494,377,71,357
2020-05-27,MAKASAR,169,2,167,49,5,44,68,20,30,7,11
2020-05-27,MAMPANG PRAPATAN,358,1,357,48,2,46,57,17,19,7,14
2020-05-27,MATRAMAN,698,7,691,113,6,107,129,42,31,11,45
2020-05-27,MENTENG,219,5,214,57,3,54,68,29,13,8,18
2020-05-27,PADEMANGAN,566,10,556,102,13,89,174,39,13,8,114
2020-05-27,PALMERAH,623,19,604,242,30,212,167,43,47,14,63
2020-05-27,PANCORAN,409,4,405,70,1,69,60,23,18,3,16
2020-05-27,PASAR MINGGU,615,5,610,172,11,161,111,35,31,14,31
2020-05-27,PASAR REBO,229,2,227,51,3,48,53,12,16,4,21
2020-05-27,PENJARINGAN,613,4,609,95,10,85,175,35,31,10,99
2020-05-27,PESANGGRAHAN,302,2,300,108,5,103,79,24,26,15,14
2020-05-27,PULO GADUNG,422,4,418,124,5,119,136,43,53,11,29
2020-05-27,SAWAH BESAR,266,7,259,191,14,177,91,44,20,8,19
2020-05-27,SENEN,548,3,545,83,3,80,102,25,22,5,50
2020-05-27,SETIA BUDI,252,5,247,72,4,68,67,22,22,9,14
2020-05-27,TAMAN SARI,201,4,197,61,11,50,102,35,18,5,44
2020-05-27,TAMBORA,293,3,290,95,25,70,108,24,5,10,69
2020-05-27,TANAH ABANG,939,6,933,196,15,181,332,67,33,17,215
2020-05-27,TANJUNG PRIOK,919,6,913,328,16,312,276,81,39,26,130
2020-05-27,TEBET,372,4,368,123,10,113,125,32,49,11,33
2020-05-28,BELUM DIKETAHUI,3723,107,3616,2584,272,2312,539,149,26,8,356
2020-05-28,CAKUNG,400,6,394,110,7,103,123,39,30,9,45
2020-05-28,CEMPAKA PUTIH,749,6,743,188,4,184,91,31,31,7,22
2020-05-28,CENGKARENG,602,2,600,85,10,75,135,43,31,10,51
2020-05-28,CILANDAK,481,0,481,184,21,163,92,20,37,14,21
2020-05-28,CILINCING,749,21,728,96,19,77,88,29,8,8,43
2020-05-28,CIPAYUNG,333,7,326,93,10,83,69,26,18,1,24
2020-05-28,CIRACAS,386,6,380,85,3,82,61,19,16,8,18
2020-05-28,DUREN SAWIT,680,14,666,150,6,144,247,52,71,25,99
2020-05-28,GAMBIR,301,7,294,71,9,62,48,19,11,6,12
2020-05-28,GROGOL PETAMBURAN,597,8,589,151,10,141,156,44,62,13,37
2020-05-28,JAGAKARSA,617,13,604,156,9,147,90,25,31,7,27
2020-05-28,JATINEGARA,377,4,373,60,5,55,142,42,39,13,48
2020-05-28,JOHAR BARU,455,4,451,71,6,65,66,16,11,11,28
2020-05-28,KALI DERES,595,1,594,190,4,186,121,34,58,11,18
2020-05-28,KEBAYORAN BARU,219,2,217,109,5,104,70,12,44,3,11
2020-05-28,KEBAYORAN LAMA,460,5,455,176,18,158,132,38,46,18,30
2020-05-28,KEBON JERUK,1083,9,1074,192,29,163,185,58,61,15,51
2020-05-28,KELAPA GADING,617,0,617,145,6,139,118,34,46,9,29
2020-05-28,KEMAYORAN,424,18,406,167,17,150,120,24,29,14,53
2020-05-28,KEMBANGAN,300,13,287,121,17,104,130,33,38,5,54
2020-05-28,KEP. SERIBU SELATAN,217,1,216,5,0,5,13,3,0,0,10
2020-05-28,KEP. SERIBU UTARA,227,3,224,14,0,14,1,0,0,0,1
2020-05-28,KOJA,678,12,666,217,32,185,116,34,19,8,55
2020-05-28,KRAMAT JATI,371,6,365,82,22,60,133,38,34,14,47
2020-05-28,LUAR DKI JAKARTA,5706,342,5364,1638,229,1409,1329,499,382,71,377
2020-05-28,MAKASAR,181,2,179,53,9,44,68,20,30,7,11
2020-05-28,MAMPANG PRAPATAN,373,2,371,49,2,47,57,17,19,7,14
2020-05-28,MATRAMAN,707,8,699,115,7,108,129,41,31,12,45
2020-05-28,MENTENG,269,4,265,58,4,54,70,30,13,9,18
2020-05-28,PADEMANGAN,599,17,582,104,14,90,175,40,13,8,114
2020-05-28,PALMERAH,660,19,641,246,34,212,169,44,47,14,64
2020-05-28,PANCORAN,433,4,429,70,1,69,62,22,19,3,18
2020-05-28,PASAR MINGGU,638,9,629,179,14,165,110,34,31,14,31
2020-05-28,PASAR REBO,239,1,238,51,3,48,53,12,16,4,21
2020-05-28,PENJARINGAN,623,4,619,96,11,85,177,35,31,10,101
2020-05-28,PESANGGRAHAN,312,3,309,114,10,104,81,24,26,15,16
2020-05-28,PULO GADUNG,432,4,428,128,8,120,137,43,55,11,28
2020-05-28,SAWAH BESAR,279,14,265,197,20,177,91,44,20,8,19
2020-05-28,SENEN,563,4,559,83,2,81,104,26,22,5,51
2020-05-28,SETIA BUDI,257,5,252,72,4,68,67,21,23,9,14
2020-05-28,TAMAN SARI,212,4,208,65,15,50,102,35,18,5,44
2020-05-28,TAMBORA,300,4,296,101,31,70,124,24,5,10,85
2020-05-28,TANAH ABANG,955,5,950,200,19,181,332,67,33,17,215
2020-05-28,TANJUNG PRIOK,947,11,936,332,17,315,279,83,39,26,131
2020-05-28,TEBET,378,5,373,124,10,114,127,32,49,12,34
2020-05-29,BELUM DIKETAHUI,4003,107,3896,2651,272,2379,580,154,26,8,392
2020-05-29,CAKUNG,407,7,400,115,12,103,123,35,34,9,45
2020-05-29,CEMPAKA PUTIH,745,6,739,190,7,183,91,25,40,7,19
2020-05-29,CENGKARENG,630,2,628,92,14,78,135,41,33,10,51
2020-05-29,CILANDAK,477,0,477,185,22,163,92,20,37,14,21
2020-05-29,CILINCING,761,25,736,106,25,81,89,26,12,8,43
2020-05-29,CIPAYUNG,349,9,340,104,13,91,69,26,18,1,24
2020-05-29,CIRACAS,397,8,389,88,3,85,61,18,17,8,18
2020-05-29,DUREN SAWIT,767,14,753,153,6,147,247,49,72,25,101
2020-05-29,GAMBIR,310,8,302,71,9,62,48,18,12,6,12
2020-05-29,GROGOL PETAMBURAN,607,9,598,153,12,141,157,43,64,13,37
2020-05-29,JAGAKARSA,619,15,604,159,10,149,93,23,33,7,30
2020-05-29,JATINEGARA,379,4,375,63,6,57,145,44,39,13,49
2020-05-29,JOHAR BARU,446,5,441,73,7,66,66,16,11,11,28
2020-05-29,KALI DERES,611,4,607,190,5,185,121,34,59,11,17
2020-05-29,KEBAYORAN BARU,215,2,213,111,7,104,70,12,44,3,11
2020-05-29,KEBAYORAN LAMA,456,6,450,180,21,159,133,38,46,18,31
2020-05-29,KEBON JERUK,1128,10,1118,193,30,163,184,56,63,15,50
2020-05-29,KELAPA GADING,604,0,604,149,8,141,118,34,46,9,29
2020-05-29,KEMAYORAN,437,18,419,172,21,151,122,25,35,14,48
2020-05-29,KEMBANGAN,307,14,293,124,19,105,131,32,39,6,54
2020-05-29,KEP. SERIBU SELATAN,242,1,241,4,0,4,13,3,0,0,10
2020-05-29,KEP. SERIBU UTARA,230,3,227,14,0,14,1,0,0,0,1
2020-05-29,KOJA,680,15,665,229,39,190,119,32,22,8,57
2020-05-29,KRAMAT JATI,353,6,347,82,22,60,143,37,36,14,56
2020-05-29,LUAR DKI JAKARTA,5991,370,5621,1819,247,1572,1366,484,406,71,405
2020-05-29,MAKASAR,181,3,178,53,10,43,68,19,31,7,11
2020-05-29,MAMPANG PRAPATAN,382,4,378,51,3,48,57,17,19,7,14
2020-05-29,MATRAMAN,710,9,701,116,8,108,131,38,34,12,47
2020-05-29,MENTENG,270,4,266,61,5,56,72,30,15,9,18
2020-05-29,PADEMANGAN,650,25,625,113,22,91,177,40,14,8,115
2020-05-29,PALMERAH,729,22,707,253,40,213,171,45,47,14,65
2020-05-29,PANCORAN,463,4,459,71,1,70,62,21,20,3,18
2020-05-29,PASAR MINGGU,631,9,622,179,15,164,110,33,32,14,31
2020-05-29,PASAR REBO,247,3,244,52,3,49,54,13,16,4,21
2020-05-29,PENJARINGAN,734,4,730,101,14,87,179,34,32,10,103
2020-05-29,PESANGGRAHAN,315,4,311,116,12,104,81,22,27,16,16
2020-05-29,PULO GADUNG,452,4,448,134,12,122,139,40,58,12,29
2020-05-29,SAWAH BESAR,288,15,273,197,20,177,91,43,21,8,19
2020-05-29,SENEN,582,5,577,85,4,81,106,28,22,5,51
2020-05-29,SETIA BUDI,258,6,252,72,4,68,67,20,24,9,14
2020-05-29,TAMAN SARI,216,4,212,67,16,51,102,35,19,5,43
2020-05-29,TAMBORA,315,6,309,103,32,71,126,25,6,10,85
2020-05-29,TANAH ABANG,964,7,957,204,19,185,332,65,35,17,215
2020-05-29,TANJUNG PRIOK,979,15,964,336,18,318,284,83,42,26,133
2020-05-29,TEBET,382,5,377,125,10,115,127,31,49,12,35
2020-05-30,BELUM DIKETAHUI,3918,101,3817,2632,244,2388,572,158,28,7,379
2020-05-30,CAKUNG,417,6,411,116,6,110,123,33,36,9,45
2020-05-30,CEMPAKA PUTIH,772,6,766,194,8,186,94,21,45,7,21
2020-05-30,CENGKARENG,637,3,634,99,17,82,137,39,35,10,53
2020-05-30,CILANDAK,479,1,478,186,8,178,92,16,41,14,21
2020-05-30,CILINCING,779,16,763,110,16,94,94,24,14,8,48
2020-05-30,CIPAYUNG,369,5,364,112,6,106,69,19,25,1,24
2020-05-30,CIRACAS,421,5,416,90,3,87,62,18,19,8,17
2020-05-30,DUREN SAWIT,821,14,807,161,2,159,251,47,77,25,102
2020-05-30,GAMBIR,318,7,311,72,8,64,49,13,17,6,13
2020-05-30,GROGOL PETAMBURAN,610,7,603,155,8,147,159,42,65,13,39
2020-05-30,JAGAKARSA,636,14,622,159,7,152,94,21,35,8,30
2020-05-30,JATINEGARA,382,4,378,64,2,62,146,38,46,13,49
2020-05-30,JOHAR BARU,452,2,450,73,4,69,67,13,15,11,28
2020-05-30,KALI DERES,621,10,611,199,13,186,122,27,66,11,18
2020-05-30,KEBAYORAN BARU,216,1,215,111,4,107,71,11,45,3,12
2020-05-30,KEBAYORAN LAMA,467,6,461,179,7,172,135,39,47,18,31
2020-05-30,KEBON JERUK,1138,12,1126,195,15,180,184,52,67,15,50
2020-05-30,KELAPA GADING,608,0,608,166,3,163,118,29,51,9,29
2020-05-30,KEMAYORAN,464,17,447,175,14,161,128,24,36,14,54
2020-05-30,KEMBANGAN,309,14,295,127,10,117,130,29,42,6,53
2020-05-30,KEP. SERIBU SELATAN,246,1,245,5,0,5,13,3,6,0,4
2020-05-30,KEP. SERIBU UTARA,230,0,230,14,0,14,1,0,0,0,1
2020-05-30,KOJA,702,12,690,236,19,217,127,32,24,8,63
2020-05-30,KRAMAT JATI,357,6,351,84,21,63,145,37,38,14,56
2020-05-30,LUAR DKI JAKARTA,6087,351,5736,1839,199,1640,1401,443,450,71,437
2020-05-30,MAKASAR,184,2,182,54,7,47,67,16,33,7,11
2020-05-30,MAMPANG PRAPATAN,382,2,380,51,2,49,57,16,20,7,14
2020-05-30,MATRAMAN,714,7,707,116,2,114,137,36,38,12,51
2020-05-30,MENTENG,302,3,299,62,2,60,73,24,22,9,18
2020-05-30,PADEMANGAN,1510,28,1482,117,19,98,184,37,17,8,122
2020-05-30,PALMERAH,739,22,717,258,20,238,173,43,49,15,66
2020-05-30,PANCORAN,477,3,474,71,0,71,62,20,22,3,17
2020-05-30,PASAR MINGGU,642,6,636,179,7,172,113,27,38,14,34
2020-05-30,PASAR REBO,249,2,247,53,2,51,54,13,16,4,21
2020-05-30,PENJARINGAN,740,4,736,102,7,95,180,32,34,11,103
2020-05-30,PESANGGRAHAN,315,4,311,119,13,106,81,17,32,16,16
2020-05-30,PULO GADUNG,464,2,462,134,4,130,140,39,60,12,29
2020-05-30,SAWAH BESAR,294,10,284,200,17,183,91,41,23,8,19
2020-05-30,SENEN,583,5,578,85,4,81,110,30,23,5,52
2020-05-30,SETIA BUDI,262,5,257,72,2,70,67,17,27,9,14
2020-05-30,TAMAN SARI,218,3,215,67,13,54,102,31,23,5,43
2020-05-30,TAMBORA,317,5,312,104,25,79,126,24,7,10,85
2020-05-30,TANAH ABANG,985,5,980,208,8,200,334,56,45,17,216
2020-05-30,TANJUNG PRIOK,1056,14,1042,337,12,325,285,76,49,26,134
2020-05-30,TEBET,405,5,400,126,6,120,131,25,55,12,39
2020-05-31,BELUM DIKETAHUI,4290,288,4002,3278,505,2773,615,144,28,7,436
2020-05-31,CAKUNG,415,7,408,112,6,106,123,32,38,9,44
2020-05-31,CEMPAKA PUTIH,762,6,756,192,7,185,94,21,45,7,21
2020-05-31,CENGKARENG,638,3,635,99,17,82,138,39,36,10,53
2020-05-31,CILANDAK,474,1,473,179,8,171,94,16,42,14,22
2020-05-31,CILINCING,768,18,750,106,15,91,94,21,17,8,48
2020-05-31,CIPAYUNG,360,5,355,108,6,102,69,19,25,1,24
2020-05-31,CIRACAS,405,6,399,89,4,85,63,18,20,8,17
2020-05-31,DUREN SAWIT,816,14,802,153,2,151,252,44,80,25,103
2020-05-31,GAMBIR,313,6,307,68,7,61,49,13,17,6,13
2020-05-31,GROGOL PETAMBURAN,605,5,600,157,8,149,161,42,66,13,40
2020-05-31,JAGAKARSA,636,14,622,153,7,146,95,22,35,8,30
2020-05-31,JATINEGARA,374,4,370,60,1,59,147,37,48,13,49
2020-05-31,JOHAR BARU,448,1,447,69,4,65,70,14,15,11,30
2020-05-31,KALI DERES,614,7,607,194,13,181,122,27,67,11,17
2020-05-31,KEBAYORAN BARU,212,1,211,109,4,105,71,10,46,3,12
2020-05-31,KEBAYORAN LAMA,460,4,456,175,6,169,135,37,49,18,31
2020-05-31,KEBON JERUK,1120,11,1109,191,16,175,184,50,69,15,50
2020-05-31,KELAPA GADING,602,0,602,166,3,163,118,28,54,9,27
2020-05-31,KEMAYORAN,458,17,441,169,12,157,132,27,38,14,53
2020-05-31,KEMBANGAN,304,11,293,126,10,116,130,25,46,6,53
2020-05-31,KEP. SERIBU SELATAN,242,1,241,5,0,5,13,3,6,0,4
2020-05-31,KEP. SERIBU UTARA,223,0,223,14,0,14,1,0,0,0,1
2020-05-31,KOJA,688,12,676,233,14,219,128,33,24,8,63
2020-05-31,KRAMAT JATI,354,7,347,83,21,62,148,39,44,14,51
2020-05-31,LUAR DKI JAKARTA,6494,446,6048,2058,281,1777,1422,441,468,72,441
2020-05-31,MAKASAR,205,2,203,53,6,47,68,15,34,7,12
2020-05-31,MAMPANG PRAPATAN,380,2,378,48,2,46,57,15,22,7,13
2020-05-31,MATRAMAN,713,7,706,114,2,112,137,36,38,12,51
2020-05-31,MENTENG,298,3,295,60,2,58,73,24,23,9,17
2020-05-31,PADEMANGAN,1497,32,1465,113,15,98,186,36,26,8,116
2020-05-31,PALMERAH,739,16,723,252,18,234,176,44,55,15,62
2020-05-31,PANCORAN,473,1,472,71,0,71,64,19,24,3,18
2020-05-31,PASAR MINGGU,636,6,630,174,7,167,114,27,38,14,35
2020-05-31,PASAR REBO,252,4,248,51,2,49,55,12,18,4,21
2020-05-31,PENJARINGAN,730,3,727,99,6,93,179,30,37,11,101
2020-05-31,PESANGGRAHAN,313,4,309,115,11,104,82,17,33,16,16
2020-05-31,PULO GADUNG,459,2,457,133,4,129,140,39,62,12,27
2020-05-31,SAWAH BESAR,293,12,281,194,16,178,92,41,25,8,18
2020-05-31,SENEN,577,5,572,84,4,80,118,33,25,5,55
2020-05-31,SETIA BUDI,284,5,279,68,2,66,67,17,27,9,14
2020-05-31,TAMAN SARI,210,4,206,63,13,50,103,31,24,5,43
2020-05-31,TAMBORA,312,5,307,103,23,80,133,26,7,10,90
2020-05-31,TANAH ABANG,974,5,969,194,8,186,337,57,53,17,210
2020-05-31,TANJUNG PRIOK,1048,17,1031,325,11,314,291,76,52,26,137
2020-05-31,TEBET,398,5,393,121,5,116,132,26,56,12,38
