tanggal,kecamatan,odp,proses_pemantauan,selesai_pemantauan,pdp,masih_dirawat,pulang_dan_sehat,positif,dirawat,sembuh,meninggal,isolasi_mandiri
2020-03-25,BELUM DIKETAHUI,774,86,688,177,115,62,89,58,2,3,26
2020-03-25,CAKUNG,10,1,9,10,6,4,8,6,0,2,0
2020-03-25,CEMPAKA PUTIH,14,2,12,5,3,2,3,1,1,0,1
2020-03-25,CENGKARENG,24,8,16,6,4,2,6,5,0,1,0
2020-03-25,CILANDAK,31,8,23,31,18,13,12,7,0,1,4
2020-03-25,CILINCING,21,5,16,4,2,2,2,0,0,1,1
2020-03-25,CIPAYUNG,19,7,12,6,5,1,1,1,0,0,0
2020-03-25,CIRACAS,12,1,11,9,4,5,3,2,0,1,0
2020-03-25,DUREN SAWIT,28,6,22,12,10,2,11,7,0,2,2
2020-03-25,GAMBIR,22,17,5,3,3,0,1,1,0,0,0
2020-03-25,GROGOL PETAMBURAN,26,16,10,22,18,4,16,14,0,0,2
2020-03-25,JAGAKARSA,11,2,9,20,12,8,8,4,0,1,3
2020-03-25,JATINEGARA,10,1,9,4,3,1,2,2,0,0,0
2020-03-25,JOHAR BARU,4,1,3,4,3,1,5,1,1,1,2
2020-03-25,KALI DERES,22,4,18,31,27,4,26,19,0,0,7
2020-03-25,KEBAYORAN BARU,21,5,16,23,17,6,20,7,1,1,11
2020-03-25,KEBAYORAN LAMA,21,4,17,23,16,7,14,10,1,1,2
2020-03-25,KEBON JERUK,13,2,11,34,26,8,22,13,0,3,6
2020-03-25,KELAPA GADING,85,67,18,17,15,2,13,9,0,2,2
2020-03-25,KEMAYORAN,9,1,8,7,5,2,4,3,0,1,0
2020-03-25,KEMBANGAN,21,9,12,19,15,4,14,9,1,0,4
2020-03-25,KEP. SERIBU SELATAN,0,0,0,0,0,0,0,0,0,0,0
2020-03-25,KEP. SERIBU UTARA,0,0,0,0,0,0,0,0,0,0,0
2020-03-25,KOJA,19,3,16,9,8,1,3,2,0,0,1
2020-03-25,KRAMAT JATI,13,4,9,19,11,8,7,2,1,0,4
2020-03-25,LUAR DKI JAKARTA,203,45,158,140,98,42,46,26,1,2,17
2020-03-25,MAKASAR,9,2,7,11,7,4,7,5,0,2,0
2020-03-25,MAMPANG PRAPATAN,17,7,10,11,5,6,8,3,3,1,1
2020-03-25,MATRAMAN,15,5,10,10,5,5,6,4,1,1,0
2020-03-25,MENTENG,15,9,6,5,4,1,2,1,0,0,1
2020-03-25,PADEMANGAN,12,7,5,2,2,0,1,1,0,0,0
2020-03-25,PALMERAH,11,2,9,9,7,2,5,2,0,0,3
2020-03-25,PANCORAN,8,2,6,9,6,3,4,3,1,0,0
2020-03-25,PASAR MINGGU,16,5,11,17,10,7,10,5,3,0,2
2020-03-25,PASAR REBO,6,3,3,10,7,3,4,1,1,1,1
2020-03-25,PENJARINGAN,35,11,24,14,7,7,6,4,0,2,0
2020-03-25,PESANGGRAHAN,18,0,18,16,14,2,10,3,0,2,5
2020-03-25,PULO GADUNG,42,0,42,22,14,8,10,7,0,1,2
2020-03-25,SAWAH BESAR,6,1,5,2,1,1,1,1,0,0,0
2020-03-25,SENEN,57,36,21,6,5,1,2,1,0,0,1
2020-03-25,SETIA BUDI,19,7,12,16,8,8,10,6,3,1,0
2020-03-25,TAMAN SARI,3,0,3,4,2,2,1,1,0,0,0
2020-03-25,TAMBORA,5,1,4,1,1,0,0,0,0,0,0
2020-03-25,TANAH ABANG,26,9,17,21,8,13,4,1,2,0,1
2020-03-25,TANJUNG PRIOK,46,34,12,17,12,5,5,3,1,0,1
2020-03-25,TEBET,16,2,14,16,10,6,8,5,0,3,0
2020-03-26,BELUM DIKETAHUI,771,90,681,180,111,69,130,98,2,7,23
2020-03-26,CAKUNG,10,1,9,14,7,7,8,6,0,2,0
2020-03-26,CEMPAKA PUTIH,14,2,12,5,3,2,3,1,1,0,1
2020-03-26,CENGKARENG,25,9,16,6,4,2,8,6,0,1,1
2020-03-26,CILANDAK,33,8,25,32,18,14,11,6,1,1,3
2020-03-26,CILINCING,26,6,20,3,1,2,1,0,0,1,0
2020-03-26,CIPAYUNG,19,7,12,7,6,1,2,1,1,0,0
2020-03-26,CIRACAS,14,1,13,10,5,5,3,2,0,1,0
2020-03-26,DUREN SAWIT,31,5,26,13,10,3,13,7,0,3,3
2020-03-26,GAMBIR,22,17,5,3,3,0,1,1,0,0,0
2020-03-26,GROGOL PETAMBURAN,27,16,11,23,18,5,18,16,0,0,2
2020-03-26,JAGAKARSA,13,4,9,20,12,8,9,4,0,1,4
2020-03-26,JATINEGARA,13,3,10,9,5,4,5,5,0,0,0
2020-03-26,JOHAR BARU,4,1,3,4,3,1,5,1,1,1,2
2020-03-26,KALI DERES,23,4,19,34,30,4,29,20,0,0,9
2020-03-26,KEBAYORAN BARU,28,5,23,26,19,7,20,7,2,1,10
2020-03-26,KEBAYORAN LAMA,25,6,19,24,16,8,14,10,1,1,2
2020-03-26,KEBON JERUK,17,2,15,37,28,9,23,14,1,3,5
2020-03-26,KELAPA GADING,86,67,19,17,15,2,13,9,0,2,2
2020-03-26,KEMAYORAN,11,3,8,8,5,3,4,3,0,1,0
2020-03-26,KEMBANGAN,23,9,14,22,17,5,14,9,1,0,4
2020-03-26,KEP. SERIBU SELATAN,0,0,0,0,0,0,0,0,0,0,0
2020-03-26,KEP. SERIBU UTARA,0,0,0,0,0,0,0,0,0,0,0
2020-03-26,KOJA,24,3,21,12,11,1,3,2,0,0,1
2020-03-26,KRAMAT JATI,17,5,12,21,13,8,10,4,1,1,4
2020-03-26,LUAR DKI JAKARTA,212,46,166,144,101,43,53,30,2,2,19
2020-03-26,MAKASAR,9,2,7,11,7,4,7,5,0,2,0
2020-03-26,MAMPANG PRAPATAN,18,7,11,11,5,6,8,2,3,2,1
2020-03-26,MATRAMAN,17,5,12,10,5,5,7,5,1,1,0
2020-03-26,MENTENG,15,9,6,7,5,2,2,1,0,0,1
2020-03-26,PADEMANGAN,12,7,5,2,2,0,1,1,0,0,0
2020-03-26,PALMERAH,11,2,9,11,9,2,6,3,0,0,3
2020-03-26,PANCORAN,11,2,9,11,6,5,4,3,1,0,0
2020-03-26,PASAR MINGGU,18,5,13,21,12,9,10,5,3,0,2
2020-03-26,PASAR REBO,7,3,4,10,7,3,4,1,1,1,1
2020-03-26,PENJARINGAN,38,11,27,16,8,8,9,6,0,3,0
2020-03-26,PESANGGRAHAN,18,0,18,18,15,3,12,3,0,4,5
2020-03-26,PULO GADUNG,46,2,44,25,15,10,11,7,0,2,2
2020-03-26,SAWAH BESAR,7,2,5,3,2,1,1,1,0,0,0
2020-03-26,SENEN,58,37,21,8,7,1,2,1,0,0,1
2020-03-26,SETIA BUDI,19,7,12,17,9,8,10,5,3,2,0
2020-03-26,TAMAN SARI,5,0,5,4,2,2,0,0,0,0,0
2020-03-26,TAMBORA,8,3,5,1,1,0,0,0,0,0,0
2020-03-26,TANAH ABANG,26,9,17,21,8,13,4,1,2,0,1
2020-03-26,TANJUNG PRIOK,45,33,12,18,13,5,8,6,1,0,1
2020-03-26,TEBET,19,2,17,17,10,7,9,6,0,3,0
2020-03-27,BELUM DIKETAHUI,783,90,693,184,112,72,122,90,2,5,25
2020-03-27,CAKUNG,10,1,9,14,7,7,8,6,0,2,0
2020-03-27,CEMPAKA PUTIH,14,2,12,6,4,2,3,1,1,0,1
2020-03-27,CENGKARENG,25,9,16,6,4,2,8,6,0,1,1
2020-03-27,CILANDAK,33,8,25,32,18,14,11,6,1,1,3
2020-03-27,CILINCING,27,6,21,3,1,2,1,0,0,1,0
2020-03-27,CIPAYUNG,19,7,12,8,7,1,2,1,1,0,0
2020-03-27,CIRACAS,14,1,13,11,5,6,3,2,0,1,0
2020-03-27,DUREN SAWIT,31,5,26,13,10,3,14,7,0,4,3
2020-03-27,GAMBIR,24,17,7,3,3,0,1,1,0,0,0
2020-03-27,GROGOL PETAMBURAN,27,16,11,23,18,5,19,16,0,0,3
2020-03-27,JAGAKARSA,13,4,9,20,12,8,11,5,0,1,5
2020-03-27,JATINEGARA,14,3,11,9,5,4,5,4,0,1,0
2020-03-27,JOHAR BARU,4,1,3,4,3,1,5,1,1,1,2
2020-03-27,KALI DERES,23,4,19,34,30,4,30,20,0,0,10
2020-03-27,KEBAYORAN BARU,28,5,23,26,19,7,22,8,2,1,11
2020-03-27,KEBAYORAN LAMA,25,6,19,24,16,8,14,10,1,1,2
2020-03-27,KEBON JERUK,17,2,15,38,29,9,24,14,2,3,5
2020-03-27,KELAPA GADING,86,67,19,18,16,2,14,9,0,2,3
2020-03-27,KEMAYORAN,11,3,8,8,5,3,4,3,0,1,0
2020-03-27,KEMBANGAN,23,9,14,23,18,5,14,8,2,0,4
2020-03-27,KEP. SERIBU SELATAN,0,0,0,0,0,0,0,0,0,0,0
2020-03-27,KEP. SERIBU UTARA,0,0,0,0,0,0,0,0,0,0,0
2020-03-27,KOJA,24,3,21,12,11,1,3,2,0,0,1
2020-03-27,KRAMAT JATI,17,5,12,21,13,8,10,4,1,1,4
2020-03-27,LUAR DKI JAKARTA,215,47,168,145,102,43,55,32,2,2,19
2020-03-27,MAKASAR,9,2,7,12,8,4,7,5,0,2,0
2020-03-27,MAMPANG PRAPATAN,18,7,11,11,5,6,8,2,3,2,1
2020-03-27,MATRAMAN,17,5,12,10,5,5,7,5,1,1,0
2020-03-27,MENTENG,16,9,7,8,6,2,2,1,0,0,1
2020-03-27,PADEMANGAN,12,7,5,2,2,0,1,1,0,0,0
2020-03-27,PALMERAH,13,3,10,11,9,2,7,3,0,0,4
2020-03-27,PANCORAN,12,2,10,11,6,5,4,3,1,0,0
2020-03-27,PASAR MINGGU,18,5,13,21,12,9,10,5,3,0,2
2020-03-27,PASAR REBO,7,3,4,12,9,3,4,1,1,1,1
2020-03-27,PENJARINGAN,38,11,27,18,10,8,9,6,0,3,0
2020-03-27,PESANGGRAHAN,18,0,18,18,15,3,13,3,0,5,5
2020-03-27,PULO GADUNG,46,2,44,26,16,10,12,8,0,2,2
2020-03-27,SAWAH BESAR,7,2,5,3,2,1,1,1,0,0,0
2020-03-27,SENEN,58,37,21,8,7,1,4,2,0,0,2
2020-03-27,SETIA BUDI,20,8,12,18,10,8,11,5,3,3,0
2020-03-27,TAMAN SARI,5,0,5,4,2,2,0,0,0,0,0
2020-03-27,TAMBORA,8,3,5,1,1,0,0,0,0,0,0
2020-03-27,TANAH ABANG,32,11,21,26,13,13,4,1,2,0,1
2020-03-27,TANJUNG PRIOK,45,33,12,18,13,5,8,6,1,0,1
2020-03-27,TEBET,18,1,17,17,10,7,9,6,0,3,0
2020-03-28,BELUM DIKETAHUI,1041,93,948,191,106,85,149,126,2,7,14
2020-03-28,CAKUNG,12,3,9,18,11,7,8,6,0,2,0
2020-03-28,CEMPAKA PUTIH,16,4,12,8,6,2,3,1,1,0,1
2020-03-28,CENGKARENG,23,7,16,9,7,2,9,6,0,2,1
2020-03-28,CILANDAK,32,8,24,33,19,14,14,5,2,1,6
2020-03-28,CILINCING,30,9,21,8,6,2,1,0,0,1,0
2020-03-28,CIPAYUNG,20,7,13,8,7,1,3,2,1,0,0
2020-03-28,CIRACAS,14,1,13,11,6,5,3,2,0,1,0
2020-03-28,DUREN SAWIT,33,6,27,13,10,3,16,9,0,4,3
2020-03-28,GAMBIR,24,17,7,5,5,0,1,1,0,0,0
2020-03-28,GROGOL PETAMBURAN,27,16,11,23,18,5,19,16,0,0,3
2020-03-28,JAGAKARSA,13,4,9,20,12,8,11,5,0,1,5
2020-03-28,JATINEGARA,14,4,10,10,6,4,7,5,0,1,1
2020-03-28,JOHAR BARU,5,2,3,4,3,1,5,1,1,1,2
2020-03-28,KALI DERES,23,4,19,29,25,4,30,20,0,0,10
2020-03-28,KEBAYORAN BARU,27,5,22,30,22,8,29,8,2,1,18
2020-03-28,KEBAYORAN LAMA,30,8,22,24,16,8,17,10,2,1,4
2020-03-28,KEBON JERUK,18,2,16,39,30,9,25,12,5,3,5
2020-03-28,KELAPA GADING,88,68,20,18,16,2,17,7,2,3,5
2020-03-28,KEMAYORAN,12,4,8,11,8,3,6,4,0,1,1
2020-03-28,KEMBANGAN,26,12,14,25,20,5,15,7,4,0,4
2020-03-28,KEP. SERIBU SELATAN,0,0,0,0,0,0,0,0,0,0,0
2020-03-28,KEP. SERIBU UTARA,0,0,0,0,0,0,0,0,0,0,0
2020-03-28,KOJA,22,3,19,13,12,1,3,2,0,0,1
2020-03-28,KRAMAT JATI,19,7,12,21,13,8,11,5,1,1,4
2020-03-28,LUAR DKI JAKARTA,229,57,172,147,106,41,68,36,4,6,22
2020-03-28,MAKASAR,10,3,7,11,7,4,9,5,0,2,2
2020-03-28,MAMPANG PRAPATAN,19,8,11,12,5,7,9,2,3,3,1
2020-03-28,MATRAMAN,17,5,12,10,5,5,7,5,1,1,0
2020-03-28,MENTENG,17,9,8,8,6,2,2,1,0,0,1
2020-03-28,PADEMANGAN,11,5,6,2,2,0,1,1,0,0,0
2020-03-28,PALMERAH,13,3,10,10,8,2,9,5,0,0,4
2020-03-28,PANCORAN,13,2,11,11,6,5,4,3,1,0,0
2020-03-28,PASAR MINGGU,17,4,13,22,13,9,10,4,4,0,2
2020-03-28,PASAR REBO,8,4,4,13,9,4,4,1,1,1,1
2020-03-28,PENJARINGAN,38,11,27,19,11,8,9,6,0,3,0
2020-03-28,PESANGGRAHAN,19,0,19,18,15,3,14,3,0,6,5
2020-03-28,PULO GADUNG,45,2,43,27,17,10,12,8,0,2,2
2020-03-28,SAWAH BESAR,8,2,6,4,3,1,2,1,0,1,0
2020-03-28,SENEN,37,15,22,10,9,1,3,2,0,0,1
2020-03-28,SETIA BUDI,21,9,12,17,9,8,11,5,3,3,0
2020-03-28,TAMAN SARI,5,0,5,4,1,3,1,1,0,0,0
2020-03-28,TAMBORA,8,2,6,3,3,0,0,0,0,0,0
2020-03-28,TANAH ABANG,33,12,21,29,16,13,5,1,2,0,2
2020-03-28,TANJUNG PRIOK,45,33,12,19,14,5,10,6,1,0,3
2020-03-28,TEBET,18,1,17,18,11,7,11,8,0,3,0
2020-03-29,BELUM DIKETAHUI,1028,97,931,207,122,85,153,125,3,9,16
2020-03-29,CAKUNG,15,4,11,20,13,7,9,6,0,2,1
2020-03-29,CEMPAKA PUTIH,16,4,12,9,7,2,4,2,1,0,1
2020-03-29,CENGKARENG,23,7,16,9,7,2,9,6,0,2,1
2020-03-29,CILANDAK,34,8,26,36,21,15,16,7,2,1,6
2020-03-29,CILINCING,32,10,22,10,8,2,1,0,0,1,0
2020-03-29,CIPAYUNG,23,7,16,10,9,1,3,2,1,0,0
2020-03-29,CIRACAS,14,1,13,12,7,5,3,2,0,1,0
2020-03-29,DUREN SAWIT,33,6,27,16,12,4,17,10,0,4,3
2020-03-29,GAMBIR,25,17,8,5,5,0,1,1,0,0,0
2020-03-29,GROGOL PETAMBURAN,28,16,12,24,19,5,20,16,0,1,3
2020-03-29,JAGAKARSA,13,4,9,21,13,8,11,5,0,1,5
2020-03-29,JATINEGARA,15,4,11,11,7,4,9,7,0,1,1
2020-03-29,JOHAR BARU,5,2,3,4,3,1,7,3,1,1,2
2020-03-29,KALI DERES,24,4,20,30,25,5,31,20,1,0,10
2020-03-29,KEBAYORAN BARU,28,5,23,31,23,8,29,8,2,1,18
2020-03-29,KEBAYORAN LAMA,32,8,24,24,16,8,21,13,2,1,5
2020-03-29,KEBON JERUK,18,2,16,39,30,9,25,11,6,3,5
2020-03-29,KELAPA GADING,89,68,21,19,17,2,20,10,2,3,5
2020-03-29,KEMAYORAN,15,4,11,12,9,3,5,3,0,1,1
2020-03-29,KEMBANGAN,28,12,16,28,22,6,17,8,4,0,5
2020-03-29,KEP. SERIBU SELATAN,0,0,0,0,0,0,0,0,0,0,0
2020-03-29,KEP. SERIBU UTARA,0,0,0,0,0,0,0,0,0,0,0
2020-03-29,KOJA,26,3,23,14,13,1,3,2,0,0,1
2020-03-29,KRAMAT JATI,22,7,15,21,13,8,11,5,1,1,4
2020-03-29,LUAR DKI JAKARTA,249,60,189,153,108,45,78,45,4,6,23
2020-03-29,MAKASAR,12,3,9,11,7,4,10,6,0,2,2
2020-03-29,MAMPANG PRAPATAN,20,8,12,12,5,7,9,2,3,3,1
2020-03-29,MATRAMAN,18,5,13,11,6,5,9,5,1,1,2
2020-03-29,MENTENG,17,9,8,8,6,2,4,2,0,1,1
2020-03-29,PADEMANGAN,13,6,7,2,2,0,1,1,0,0,0
2020-03-29,PALMERAH,15,3,12,10,8,2,10,5,0,0,5
2020-03-29,PANCORAN,14,2,12,11,6,5,5,4,1,0,0
2020-03-29,PASAR MINGGU,17,4,13,24,13,11,12,6,4,0,2
2020-03-29,PASAR REBO,9,4,5,13,9,4,4,1,1,1,1
2020-03-29,PENJARINGAN,39,11,28,20,11,9,9,6,0,3,0
2020-03-29,PESANGGRAHAN,19,0,19,18,15,3,14,3,0,6,5
2020-03-29,PULO GADUNG,49,3,46,28,18,10,12,8,0,2,2
2020-03-29,SAWAH BESAR,9,2,7,5,4,1,2,1,0,1,0
2020-03-29,SENEN,37,15,22,11,10,1,3,2,0,0,1
2020-03-29,SETIA BUDI,27,9,18,17,9,8,11,5,3,3,0
2020-03-29,TAMAN SARI,5,0,5,4,1,3,1,1,0,0,0
2020-03-29,TAMBORA,9,2,7,3,3,0,1,1,0,0,0
2020-03-29,TANAH ABANG,37,13,24,29,16,13,5,1,2,0,2
2020-03-29,TANJUNG PRIOK,47,34,13,21,16,5,10,6,1,0,3
2020-03-29,TEBET,18,1,17,18,11,7,12,9,0,3,0
2020-03-30,BELUM DIKETAHUI,1004,96,908,206,120,86,179,147,2,12,18
2020-03-30,CAKUNG,18,5,13,21,14,7,10,7,0,2,1
2020-03-30,CEMPAKA PUTIH,17,4,13,9,7,2,5,2,1,0,2
2020-03-30,CENGKARENG,26,7,19,9,7,2,9,6,0,2,1
2020-03-30,CILANDAK,35,8,27,36,21,15,18,7,3,2,6
2020-03-30,CILINCING,33,10,23,10,8,2,2,1,0,1,0
2020-03-30,CIPAYUNG,24,7,17,10,9,1,4,3,1,0,0
2020-03-30,CIRACAS,15,2,13,12,7,5,3,2,0,1,0
2020-03-30,DUREN SAWIT,36,6,30,16,12,4,19,11,0,5,3
2020-03-30,GAMBIR,13,5,8,5,5,0,1,1,0,0,0
2020-03-30,GROGOL PETAMBURAN,29,17,12,25,20,5,25,21,0,1,3
2020-03-30,JAGAKARSA,14,4,10,21,13,8,11,5,0,1,5
2020-03-30,JATINEGARA,16,4,12,11,7,4,9,7,0,1,1
2020-03-30,JOHAR BARU,7,4,3,4,3,1,7,3,1,1,2
2020-03-30,KALI DERES,25,4,21,30,25,5,31,19,1,1,10
2020-03-30,KEBAYORAN BARU,28,5,23,31,23,8,30,9,2,1,18
2020-03-30,KEBAYORAN LAMA,32,8,24,24,16,8,22,13,3,1,5
2020-03-30,KEBON JERUK,20,4,16,39,30,9,30,16,6,3,5
2020-03-30,KELAPA GADING,89,68,21,20,18,2,25,12,3,4,6
2020-03-30,KEMAYORAN,17,4,13,13,9,4,5,3,0,1,1
2020-03-30,KEMBANGAN,28,12,16,28,22,6,17,8,4,0,5
2020-03-30,KEP. SERIBU SELATAN,0,0,0,0,0,0,0,0,0,0,0
2020-03-30,KEP. SERIBU UTARA,0,0,0,0,0,0,0,0,0,0,0
2020-03-30,KOJA,26,3,23,14,13,1,4,3,0,0,1
2020-03-30,KRAMAT JATI,23,8,15,21,13,8,12,6,1,1,4
2020-03-30,LUAR DKI JAKARTA,265,66,199,153,108,45,82,49,4,7,22
2020-03-30,MAKASAR,12,3,9,11,7,4,10,6,0,2,2
2020-03-30,MAMPANG PRAPATAN,21,8,13,13,6,7,9,2,3,3,1
2020-03-30,MATRAMAN,21,6,15,11,6,5,9,5,1,1,2
2020-03-30,MENTENG,17,9,8,8,6,2,5,3,0,1,1
2020-03-30,PADEMANGAN,13,6,7,2,2,0,1,1,0,0,0
2020-03-30,PALMERAH,16,3,13,10,8,2,10,5,0,0,5
2020-03-30,PANCORAN,14,2,12,11,6,5,5,4,1,0,0
2020-03-30,PASAR MINGGU,17,4,13,24,13,11,13,7,4,0,2
2020-03-30,PASAR REBO,11,4,7,13,9,4,5,2,1,1,1
2020-03-30,PENJARINGAN,40,11,29,20,11,9,9,6,0,3,0
2020-03-30,PESANGGRAHAN,19,0,19,18,15,3,19,5,0,6,8
2020-03-30,PULO GADUNG,52,4,48,28,18,10,14,9,0,2,3
2020-03-30,SAWAH BESAR,9,2,7,5,4,1,3,1,0,1,1
2020-03-30,SENEN,39,16,23,11,10,1,3,2,0,0,1
2020-03-30,SETIA BUDI,29,9,20,17,9,8,12,6,3,3,0
2020-03-30,TAMAN SARI,5,0,5,4,1,3,1,1,0,0,0
2020-03-30,TAMBORA,9,2,7,3,3,0,2,1,0,1,0
2020-03-30,TANAH ABANG,38,13,25,30,17,13,5,1,2,0,2
2020-03-30,TANJUNG PRIOK,49,34,15,21,16,5,11,6,1,1,3
2020-03-30,TEBET,18,1,17,18,11,7,14,11,0,3,0
2020-03-31,BELUM DIKETAHUI,1005,94,911,213,126,87,154,130,2,8,14
2020-03-31,CAKUNG,19,5,14,22,15,7,12,9,0,2,1
2020-03-31,CEMPAKA PUTIH,17,4,13,11,9,2,5,2,1,0,2
2020-03-31,CENGKARENG,28,8,20,10,7,3,9,6,0,2,1
2020-03-31,CILANDAK,37,8,29,41,24,17,22,10,3,3,6
2020-03-31,CILINCING,34,10,24,14,11,3,3,1,0,2,0
2020-03-31,CIPAYUNG,25,8,17,13,12,1,6,5,1,0,0
2020-03-31,CIRACAS,16,3,13,14,9,5,3,2,0,1,0
2020-03-31,DUREN SAWIT,37,6,31,20,16,4,26,16,0,7,3
2020-03-31,GAMBIR,14,5,9,7,7,0,4,1,0,2,1
2020-03-31,GROGOL PETAMBURAN,32,17,15,28,23,5,26,21,0,1,4
2020-03-31,JAGAKARSA,20,4,16,24,15,9,14,7,0,1,6
2020-03-31,JATINEGARA,16,4,12,11,7,4,11,7,0,1,3
2020-03-31,JOHAR BARU,8,4,4,5,4,1,8,4,1,1,2
2020-03-31,KALI DERES,26,4,22,30,25,5,34,20,1,2,11
2020-03-31,KEBAYORAN BARU,29,5,24,33,25,8,31,10,2,1,18
2020-03-31,KEBAYORAN LAMA,34,8,26,26,18,8,23,13,3,1,6
2020-03-31,KEBON JERUK,20,3,17,42,33,9,37,18,6,3,10
2020-03-31,KELAPA GADING,88,64,24,25,22,3,25,11,4,4,6
2020-03-31,KEMAYORAN,17,5,12,17,13,4,8,5,0,1,2
2020-03-31,KEMBANGAN,30,12,18,28,22,6,20,10,4,1,5
2020-03-31,KEP. SERIBU SELATAN,0,0,0,0,0,0,0,0,0,0,0
2020-03-31,KEP. SERIBU UTARA,0,0,0,0,0,0,0,0,0,0,0
2020-03-31,KOJA,31,4,27,19,17,2,4,2,0,1,1
2020-03-31,KRAMAT JATI,25,9,16,23,15,8,15,7,1,1,6
2020-03-31,LUAR DKI JAKARTA,274,63,211,176,123,53,106,62,5,10,29
2020-03-31,MAKASAR,12,3,9,14,7,7,12,8,0,1,3
2020-03-31,MAMPANG PRAPATAN,22,8,14,13,6,7,11,4,3,3,1
2020-03-31,MATRAMAN,26,7,19,15,10,5,9,5,1,1,2
2020-03-31,MENTENG,17,9,8,8,6,2,7,3,0,2,2
2020-03-31,PADEMANGAN,14,6,8,6,5,1,4,2,0,2,0
2020-03-31,PALMERAH,17,3,14,10,8,2,11,6,0,0,5
2020-03-31,PANCORAN,17,2,15,14,8,6,6,5,1,0,0
2020-03-31,PASAR MINGGU,28,4,24,30,15,15,15,8,4,0,3
2020-03-31,PASAR REBO,11,4,7,15,10,5,9,2,2,3,2
2020-03-31,PENJARINGAN,43,10,33,29,19,10,9,6,0,3,0
2020-03-31,PESANGGRAHAN,19,0,19,21,18,3,16,3,0,6,7
2020-03-31,PULO GADUNG,54,4,50,31,21,10,15,9,0,3,3
2020-03-31,SAWAH BESAR,10,3,7,8,7,1,4,2,0,1,1
2020-03-31,SENEN,39,16,23,11,10,1,4,3,0,0,1
2020-03-31,SETIA BUDI,32,9,23,21,13,8,12,6,3,3,0
2020-03-31,TAMAN SARI,8,1,7,6,3,3,1,1,0,0,0
2020-03-31,TAMBORA,9,2,7,3,3,0,1,1,0,0,0
2020-03-31,TANAH ABANG,40,13,27,32,19,13,5,1,2,0,2
2020-03-31,TANJUNG PRIOK,50,35,15,29,23,6,13,8,1,1,3
2020-03-31,TEBET,22,3,19,21,13,8,24,19,0,3,2
