tanggal,kecamatan,odp,proses_pemantauan,selesai_pemantauan,pdp,masih_dirawat,pulang_dan_sehat,positif,dirawat,sembuh,meninggal,isolasi_mandiri
2020-04-01,BELUM DIKETAHUI,1005,94,911,213,126,87,154,130,2,8,14
2020-04-01,CAKUNG,19,5,14,22,15,7,12,9,0,2,1
2020-04-01,CEMPAKA PUTIH,17,4,13,11,9,2,5,2,1,0,2
2020-04-01,CENGKARENG,28,8,20,10,7,3,9,6,0,2,1
2020-04-01,CILANDAK,37,8,29,41,24,17,22,10,3,3,6
2020-04-01,CILINCING,34,10,24,14,11,3,3,1,0,2,0
2020-04-01,CIPAYUNG,25,8,17,13,12,1,6,5,1,0,0
2020-04-01,CIRACAS,16,3,13,14,9,5,3,2,0,1,0
2020-04-01,DUREN SAWIT,37,6,31,20,16,4,26,16,0,7,3
2020-04-01,GAMBIR,14,5,9,7,7,0,4,1,0,2,1
2020-04-01,GROGOL PETAMBURAN,32,17,15,28,23,5,26,21,0,1,4
2020-04-01,JAGAKARSA,20,4,16,24,15,9,14,7,0,1,6
2020-04-01,JATINEGARA,16,4,12,11,7,4,11,7,0,1,3
2020-04-01,JOHAR BARU,8,4,4,5,4,1,8,4,1,1,2
2020-04-01,KALI DERES,26,4,22,30,25,5,34,20,1,2,11
2020-04-01,KEBAYORAN BARU,29,5,24,33,25,8,31,10,2,1,18
2020-04-01,KEBAYORAN LAMA,34,8,26,26,18,8,23,13,3,1,6
2020-04-01,KEBON JERUK,20,3,17,42,33,9,37,18,6,3,10
2020-04-01,KELAPA GADING,88,64,24,25,22,3,25,11,4,4,6
2020-04-01,KEMAYORAN,17,5,12,17,13,4,8,5,0,1,2
2020-04-01,KEMBANGAN,30,12,18,28,22,6,20,10,4,1,5
2020-04-01,KEP. SERIBU SELATAN,0,0,0,0,0,0,0,0,0,0,0
2020-04-01,KEP. SERIBU UTARA,0,0,0,0,0,0,0,0,0,0,0
2020-04-01,KOJA,31,4,27,19,17,2,4,2,0,1,1
2020-04-01,KRAMAT JATI,25,9,16,23,15,8,15,7,1,1,6
2020-04-01,LUAR DKI JAKARTA,274,63,211,176,123,53,106,62,5,10,29
2020-04-01,MAKASAR,12,3,9,14,7,7,12,8,0,1,3
2020-04-01,MAMPANG PRAPATAN,22,8,14,13,6,7,11,4,3,3,1
2020-04-01,MATRAMAN,26,7,19,15,10,5,9,5,1,1,2
2020-04-01,MENTENG,17,9,8,8,6,2,7,3,0,2,2
2020-04-01,PADEMANGAN,14,6,8,6,5,1,4,2,0,2,0
2020-04-01,PALMERAH,17,3,14,10,8,2,11,6,0,0,5
2020-04-01,PANCORAN,17,2,15,14,8,6,6,5,1,0,0
2020-04-01,PASAR MINGGU,28,4,24,30,15,15,15,8,4,0,3
2020-04-01,PASAR REBO,11,4,7,15,10,5,9,2,2,3,2
2020-04-01,PENJARINGAN,43,10,33,29,19,10,9,6,0,3,0
2020-04-01,PESANGGRAHAN,19,0,19,21,18,3,16,3,0,6,7
2020-04-01,PULO GADUNG,54,4,50,31,21,10,15,9,0,3,3
2020-04-01,SAWAH BESAR,10,3,7,8,7,1,4,2,0,1,1
2020-04-01,SENEN,39,16,23,11,10,1,4,3,0,0,1
2020-04-01,SETIA BUDI,32,9,23,21,13,8,12,6,3,3,0
2020-04-01,TAMAN SARI,8,1,7,6,3,3,1,1,0,0,0
2020-04-01,TAMBORA,9,2,7,3,3,0,1,1,0,0,0
2020-04-01,TANAH ABANG,40,13,27,32,19,13,5,1,2,0,2
2020-04-01,TANJUNG PRIOK,50,35,15,29,23,6,13,8,1,1,3
2020-04-01,TEBET,22,3,19,21,13,8,24,19,0,3,2
2020-04-02,BELUM DIKETAHUI,1015,88,927,205,118,87,216,200,1,8,7
2020-04-02,CAKUNG,19,5,14,23,14,9,12,9,0,2,1
2020-04-02,CEMPAKA PUTIH,17,4,13,11,8,3,6,3,1,0,2
2020-04-02,CENGKARENG,28,8,20,10,7,3,9,6,0,2,1
2020-04-02,CILANDAK,40,8,32,42,25,17,22,10,3,3,6
2020-04-02,CILINCING,35,10,25,14,11,3,3,1,0,2,0
2020-04-02,CIPAYUNG,25,8,17,13,12,1,8,5,2,0,1
2020-04-02,CIRACAS,16,3,13,14,9,5,3,2,0,1,0
2020-04-02,DUREN SAWIT,40,6,34,20,16,4,29,18,0,8,3
2020-04-02,GAMBIR,14,5,9,7,7,0,5,1,0,2,2
2020-04-02,GROGOL PETAMBURAN,33,18,15,28,23,5,26,21,0,1,4
2020-04-02,JAGAKARSA,23,3,20,23,14,9,14,7,0,1,6
2020-04-02,JATINEGARA,16,4,12,11,7,4,12,7,0,1,4
2020-04-02,JOHAR BARU,8,3,5,5,4,1,8,4,1,1,2
2020-04-02,KALI DERES,26,4,22,30,25,5,34,20,1,2,11
2020-04-02,KEBAYORAN BARU,29,5,24,33,24,9,31,10,2,1,18
2020-04-02,KEBAYORAN LAMA,37,9,28,26,17,9,25,14,3,2,6
2020-04-02,KEBON JERUK,18,2,16,42,32,10,37,17,6,3,11
2020-04-02,KELAPA GADING,88,64,24,25,22,3,24,10,4,4,6
2020-04-02,KEMAYORAN,19,6,13,17,13,4,13,8,0,1,4
2020-04-02,KEMBANGAN,30,12,18,30,23,7,20,10,4,1,5
2020-04-02,KEP. SERIBU SELATAN,0,0,0,0,0,0,0,0,0,0,0
2020-04-02,KEP. SERIBU UTARA,0,0,0,0,0,0,0,0,0,0,0
2020-04-02,KOJA,32,4,28,19,17,2,4,2,0,1,1
2020-04-02,KRAMAT JATI,25,9,16,23,15,8,15,6,1,1,7
2020-04-02,LUAR DKI JAKARTA,296,65,231,187,128,59,116,65,6,10,35
2020-04-02,MAKASAR,13,3,10,14,7,7,13,8,0,1,4
2020-04-02,MAMPANG PRAPATAN,24,8,16,13,6,7,11,4,3,3,1
2020-04-02,MATRAMAN,28,8,20,15,10,5,10,6,1,1,2
2020-04-02,MENTENG,17,9,8,8,6,2,8,4,0,2,2
2020-04-02,PADEMANGAN,15,6,9,6,5,1,4,2,0,2,0
2020-04-02,PALMERAH,17,3,14,10,8,2,11,6,0,0,5
2020-04-02,PANCORAN,17,2,15,14,8,6,6,5,1,0,0
2020-04-02,PASAR MINGGU,31,5,26,29,14,15,15,8,4,0,3
2020-04-02,PASAR REBO,11,4,7,15,10,5,10,3,2,3,2
2020-04-02,PENJARINGAN,46,10,36,30,19,11,9,6,0,3,0
2020-04-02,PESANGGRAHAN,20,0,20,22,19,3,16,3,0,6,7
2020-04-02,PULO GADUNG,55,4,51,31,21,10,15,9,0,3,3
2020-04-02,SAWAH BESAR,10,3,7,8,7,1,4,2,0,1,1
2020-04-02,SENEN,39,16,23,12,11,1,4,3,0,0,1
2020-04-02,SETIA BUDI,32,9,23,21,13,8,12,6,3,3,0
2020-04-02,TAMAN SARI,9,1,8,6,3,3,1,1,0,0,0
2020-04-02,TAMBORA,9,2,7,3,3,0,1,1,0,0,0
2020-04-02,TANAH ABANG,40,13,27,32,17,15,5,1,2,0,2
2020-04-02,TANJUNG PRIOK,53,35,18,29,23,6,14,9,1,1,3
2020-04-02,TEBET,23,3,20,21,13,8,24,19,0,3,2
2020-04-03,BELUM DIKETAHUI,1014,88,926,1009,120,889,235,216,2,11,6
2020-04-03,CAKUNG,20,6,14,25,16,9,12,9,0,2,1
2020-04-03,CEMPAKA PUTIH,17,4,13,11,8,3,7,4,1,0,2
2020-04-03,CENGKARENG,29,8,21,10,7,3,12,8,0,2,2
2020-04-03,CILANDAK,41,8,33,43,26,17,21,8,3,4,6
2020-04-03,CILINCING,37,10,27,14,11,3,4,2,0,2,0
2020-04-03,CIPAYUNG,26,8,18,15,14,1,8,5,2,0,1
2020-04-03,CIRACAS,17,4,13,14,9,5,5,2,1,1,1
2020-04-03,DUREN SAWIT,42,8,34,22,17,5,34,21,0,9,4
2020-04-03,GAMBIR,15,5,10,8,7,1,6,2,0,2,2
2020-04-03,GROGOL PETAMBURAN,34,18,16,27,22,5,30,21,2,3,4
2020-04-03,JAGAKARSA,23,3,20,24,14,10,16,8,0,1,7
2020-04-03,JATINEGARA,16,4,12,11,7,4,13,8,0,1,4
2020-04-03,JOHAR BARU,9,4,5,5,4,1,9,5,1,1,2
2020-04-03,KALI DERES,26,4,22,30,25,5,36,20,1,2,13
2020-04-03,KEBAYORAN BARU,30,5,25,34,25,9,32,11,2,1,18
2020-04-03,KEBAYORAN LAMA,39,9,30,27,18,9,26,15,3,2,6
2020-04-03,KEBON JERUK,18,2,16,43,32,11,43,21,6,3,13
2020-04-03,KELAPA GADING,88,64,24,28,25,3,27,12,4,4,7
2020-04-03,KEMAYORAN,23,7,16,18,14,4,13,8,0,1,4
2020-04-03,KEMBANGAN,30,12,18,31,24,7,20,10,4,1,5
2020-04-03,KEP. SERIBU SELATAN,0,0,0,0,0,0,0,0,0,0,0
2020-04-03,KEP. SERIBU UTARA,0,0,0,0,0,0,0,0,0,0,0
2020-04-03,KOJA,37,5,32,20,18,2,6,4,0,1,1
2020-04-03,KRAMAT JATI,25,9,16,23,15,8,15,4,1,2,8
2020-04-03,LUAR DKI JAKARTA,306,67,239,192,131,61,136,82,6,10,38
2020-04-03,MAKASAR,14,4,10,14,7,7,13,8,0,1,4
2020-04-03,MAMPANG PRAPATAN,24,8,16,13,6,7,12,4,3,3,2
2020-04-03,MATRAMAN,31,8,23,15,10,5,11,4,1,1,5
2020-04-03,MENTENG,17,9,8,8,6,2,9,5,0,2,2
2020-04-03,PADEMANGAN,17,6,11,5,4,1,5,3,0,2,0
2020-04-03,PALMERAH,18,4,14,10,8,2,14,8,0,0,6
2020-04-03,PANCORAN,17,2,15,14,8,6,6,5,1,0,0
2020-04-03,PASAR MINGGU,32,5,27,29,14,15,16,9,4,0,3
2020-04-03,PASAR REBO,11,4,7,16,11,5,10,3,2,3,2
2020-04-03,PENJARINGAN,49,10,39,29,18,11,13,9,0,3,1
2020-04-03,PESANGGRAHAN,22,1,21,23,20,3,18,5,0,6,7
2020-04-03,PULO GADUNG,56,4,52,32,22,10,22,10,0,3,9
2020-04-03,SAWAH BESAR,11,3,8,8,7,1,4,2,0,1,1
2020-04-03,SENEN,39,16,23,12,11,1,4,3,0,0,1
2020-04-03,SETIA BUDI,32,9,23,20,12,8,14,7,3,3,1
2020-04-03,TAMAN SARI,9,1,8,8,5,3,2,1,0,0,1
2020-04-03,TAMBORA,10,2,8,4,4,0,2,2,0,0,0
2020-04-03,TANAH ABANG,40,13,27,35,20,15,7,3,2,0,2
2020-04-03,TANJUNG PRIOK,62,39,23,29,23,6,15,8,1,1,5
2020-04-03,TEBET,23,3,20,21,13,8,27,22,0,3,2
2020-04-04,BELUM DIKETAHUI,1014,88,926,1009,120,889,270,256,2,6,6
2020-04-04,CAKUNG,20,6,14,25,16,9,12,9,1,2,0
2020-04-04,CEMPAKA PUTIH,17,4,13,11,8,3,8,4,1,0,3
2020-04-04,CENGKARENG,29,8,21,10,7,3,12,8,0,2,2
2020-04-04,CILANDAK,41,8,33,43,26,17,22,9,3,4,6
2020-04-04,CILINCING,37,10,27,14,11,3,4,2,0,2,0
2020-04-04,CIPAYUNG,26,8,18,15,14,1,9,6,2,0,1
2020-04-04,CIRACAS,17,4,13,14,9,5,6,2,1,1,2
2020-04-04,DUREN SAWIT,42,8,34,22,17,5,35,22,0,9,4
2020-04-04,GAMBIR,15,5,10,8,7,1,7,3,0,2,2
2020-04-04,GROGOL PETAMBURAN,34,18,16,27,22,5,31,21,2,4,4
2020-04-04,JAGAKARSA,23,3,20,24,14,10,17,9,0,1,7
2020-04-04,JATINEGARA,16,4,12,11,7,4,16,10,0,1,5
2020-04-04,JOHAR BARU,9,4,5,6,5,1,9,5,1,1,2
2020-04-04,KALI DERES,26,4,22,30,25,5,39,21,1,3,14
2020-04-04,KEBAYORAN BARU,30,5,25,34,25,9,33,11,3,1,18
2020-04-04,KEBAYORAN LAMA,39,9,30,27,18,9,27,16,3,2,6
2020-04-04,KEBON JERUK,18,2,16,43,32,11,43,21,6,3,13
2020-04-04,KELAPA GADING,88,64,24,28,25,3,28,12,4,5,7
2020-04-04,KEMAYORAN,23,7,16,18,14,4,14,9,0,1,4
2020-04-04,KEMBANGAN,30,12,18,31,24,7,20,10,4,1,5
2020-04-04,KEP. SERIBU SELATAN,0,0,0,0,0,0,0,0,0,0,0
2020-04-04,KEP. SERIBU UTARA,0,0,0,0,0,0,0,0,0,0,0
2020-04-04,KOJA,37,5,32,20,18,2,6,4,0,1,1
2020-04-04,KRAMAT JATI,25,9,16,23,15,8,17,4,1,2,10
2020-04-04,LUAR DKI JAKARTA,306,67,239,192,131,61,153,92,6,12,43
2020-04-04,MAKASAR,14,4,10,14,7,7,13,8,0,1,4
2020-04-04,MAMPANG PRAPATAN,24,8,16,13,6,7,12,4,3,3,2
2020-04-04,MATRAMAN,31,8,23,15,10,5,12,5,1,1,5
2020-04-04,MENTENG,17,9,8,8,6,2,9,5,0,2,2
2020-04-04,PADEMANGAN,17,6,11,5,4,1,6,4,0,2,0
2020-04-04,PALMERAH,18,4,14,10,8,2,16,10,0,0,6
2020-04-04,PANCORAN,17,2,15,15,9,6,6,5,1,0,0
2020-04-04,PASAR MINGGU,32,5,27,29,14,15,16,9,4,0,3
2020-04-04,PASAR REBO,11,4,7,16,11,5,10,3,2,3,2
2020-04-04,PENJARINGAN,49,10,39,29,18,11,14,10,0,3,1
2020-04-04,PESANGGRAHAN,22,1,21,23,20,3,19,5,0,6,8
2020-04-04,PULO GADUNG,56,4,52,32,22,10,22,10,0,3,9
2020-04-04,SAWAH BESAR,11,3,8,8,7,1,4,2,0,1,1
2020-04-04,SENEN,39,16,23,12,11,1,4,3,0,0,1
2020-04-04,SETIA BUDI,32,9,23,20,12,8,14,7,3,3,1
2020-04-04,TAMAN SARI,9,1,8,8,5,3,2,1,0,0,1
2020-04-04,TAMBORA,10,2,8,4,4,0,3,3,0,0,0
2020-04-04,TANAH ABANG,40,13,27,35,20,15,7,3,2,0,2
2020-04-04,TANJUNG PRIOK,62,39,23,29,23,6,16,8,1,2,5
2020-04-04,TEBET,23,3,20,21,13,8,28,23,0,3,2
2020-04-05,BELUM DIKETAHUI,1015,88,927,1017,127,890,283,265,2,10,6
2020-04-05,CAKUNG,20,6,14,26,17,9,14,10,1,2,1
2020-04-05,CEMPAKA PUTIH,17,4,13,11,8,3,9,4,1,1,3
2020-04-05,CENGKARENG,29,8,21,10,7,3,13,8,0,3,2
2020-04-05,CILANDAK,41,8,33,43,26,17,23,10,3,4,6
2020-04-05,CILINCING,37,10,27,15,12,3,4,2,0,2,0
2020-04-05,CIPAYUNG,26,8,18,17,16,1,9,6,2,0,1
2020-04-05,CIRACAS,17,4,13,15,10,5,8,3,1,2,2
2020-04-05,DUREN SAWIT,42,8,34,22,17,5,41,26,0,9,6
2020-04-05,GAMBIR,15,5,10,9,8,1,7,2,0,3,2
2020-04-05,GROGOL PETAMBURAN,34,18,16,27,22,5,32,21,2,4,5
2020-04-05,JAGAKARSA,23,3,20,24,14,10,18,10,0,1,7
2020-04-05,JATINEGARA,16,4,12,11,7,4,18,10,0,1,7
2020-04-05,JOHAR BARU,9,4,5,6,5,1,10,5,1,2,2
2020-04-05,KALI DERES,26,4,22,30,25,5,40,22,1,3,14
2020-04-05,KEBAYORAN BARU,30,5,25,35,26,9,34,12,3,1,18
2020-04-05,KEBAYORAN LAMA,39,9,30,27,18,9,31,18,3,2,8
2020-04-05,KEBON JERUK,18,2,16,43,32,11,44,21,6,3,14
2020-04-05,KELAPA GADING,88,64,24,29,26,3,30,12,4,6,8
2020-04-05,KEMAYORAN,23,7,16,18,14,4,15,9,0,2,4
2020-04-05,KEMBANGAN,30,12,18,32,25,7,21,11,4,1,5
2020-04-05,KEP. SERIBU SELATAN,0,0,0,0,0,0,0,0,0,0,0
2020-04-05,KEP. SERIBU UTARA,0,0,0,0,0,0,0,0,0,0,0
2020-04-05,KOJA,37,5,32,20,18,2,9,5,0,1,3
2020-04-05,KRAMAT JATI,25,9,16,23,15,8,16,3,1,2,10
2020-04-05,LUAR DKI JAKARTA,306,67,239,194,133,61,163,99,6,12,46
2020-04-05,MAKASAR,14,4,10,14,7,7,14,9,0,1,4
2020-04-05,MAMPANG PRAPATAN,25,8,17,13,6,7,12,4,3,3,2
2020-04-05,MATRAMAN,32,8,24,15,10,5,13,5,1,1,6
2020-04-05,MENTENG,17,9,8,8,6,2,9,5,0,2,2
2020-04-05,PADEMANGAN,17,6,11,5,4,1,6,4,0,2,0
2020-04-05,PALMERAH,18,4,14,11,9,2,17,10,0,0,7
2020-04-05,PANCORAN,17,2,15,15,9,6,6,5,1,0,0
2020-04-05,PASAR MINGGU,32,5,27,29,14,15,18,10,4,1,3
2020-04-05,PASAR REBO,12,4,8,16,11,5,10,3,2,3,2
2020-04-05,PENJARINGAN,49,10,39,29,18,11,16,11,0,3,2
2020-04-05,PESANGGRAHAN,23,1,22,23,20,3,20,5,0,6,9
2020-04-05,PULO GADUNG,56,4,52,32,22,10,24,11,0,3,10
2020-04-05,SAWAH BESAR,11,3,8,8,7,1,5,2,0,1,2
2020-04-05,SENEN,39,16,23,12,11,1,5,3,0,0,2
2020-04-05,SETIA BUDI,32,9,23,20,12,8,14,7,3,3,1
2020-04-05,TAMAN SARI,9,1,8,8,5,3,2,1,0,0,1
2020-04-05,TAMBORA,10,2,8,4,4,0,3,3,0,0,0
2020-04-05,TANAH ABANG,41,13,28,37,22,15,9,4,2,0,3
2020-04-05,TANJUNG PRIOK,62,39,23,30,24,6,16,8,1,2,5
2020-04-05,TEBET,23,3,20,23,15,8,32,24,0,3,5
2020-04-06,BELUM DIKETAHUI,1016,88,928,1025,136,889,312,297,3,7,5
2020-04-06,CAKUNG,21,6,15,27,18,9,16,11,1,3,1
2020-04-06,CEMPAKA PUTIH,18,4,14,10,7,3,10,5,1,1,3
2020-04-06,CENGKARENG,30,8,22,10,7,3,14,8,0,3,3
2020-04-06,CILANDAK,42,8,34,43,26,17,23,10,3,4,6
2020-04-06,CILINCING,41,10,31,19,16,3,3,1,0,2,0
2020-04-06,CIPAYUNG,29,8,21,18,17,1,9,6,2,0,1
2020-04-06,CIRACAS,19,5,14,16,11,5,10,4,1,3,2
2020-04-06,DUREN SAWIT,43,8,35,22,17,5,46,27,0,9,10
2020-04-06,GAMBIR,15,5,10,9,8,1,7,2,0,3,2
2020-04-06,GROGOL PETAMBURAN,35,18,17,28,23,5,33,22,2,4,5
2020-04-06,JAGAKARSA,24,3,21,25,15,10,21,12,0,1,8
2020-04-06,JATINEGARA,17,5,12,11,7,4,19,11,0,1,7
2020-04-06,JOHAR BARU,9,4,5,6,5,1,10,5,2,2,1
2020-04-06,KALI DERES,26,4,22,30,25,5,47,24,1,4,18
2020-04-06,KEBAYORAN BARU,30,5,25,35,26,9,34,12,3,1,18
2020-04-06,KEBAYORAN LAMA,39,9,30,32,22,10,33,18,3,4,8
2020-04-06,KEBON JERUK,18,2,16,43,32,11,45,21,6,3,15
2020-04-06,KELAPA GADING,88,64,24,29,26,3,31,11,6,6,8
2020-04-06,KEMAYORAN,24,7,17,18,14,4,13,9,0,1,3
2020-04-06,KEMBANGAN,31,12,19,32,25,7,24,13,4,1,6
2020-04-06,KEP. SERIBU SELATAN,0,0,0,0,0,0,0,0,0,0,0
2020-04-06,KEP. SERIBU UTARA,0,0,0,0,0,0,0,0,0,0,0
2020-04-06,KOJA,38,6,32,20,18,2,11,7,1,1,2
2020-04-06,KRAMAT JATI,25,9,16,24,16,8,17,3,1,2,11
2020-04-06,LUAR DKI JAKARTA,310,69,241,198,137,61,191,106,6,18,61
2020-04-06,MAKASAR,14,4,10,14,7,7,16,10,0,1,5
2020-04-06,MAMPANG PRAPATAN,25,8,17,14,7,7,14,5,3,3,3
2020-04-06,MATRAMAN,34,8,26,17,12,5,22,7,1,2,12
2020-04-06,MENTENG,17,9,8,8,6,2,11,4,1,4,2
2020-04-06,PADEMANGAN,17,6,11,5,4,1,6,4,0,2,0
2020-04-06,PALMERAH,18,4,14,12,10,2,18,11,0,0,7
2020-04-06,PANCORAN,17,2,15,15,9,6,7,5,1,0,1
2020-04-06,PASAR MINGGU,32,5,27,30,15,15,20,12,4,1,3
2020-04-06,PASAR REBO,12,4,8,17,12,5,10,3,2,3,2
2020-04-06,PENJARINGAN,49,10,39,29,18,11,20,12,1,4,3
2020-04-06,PESANGGRAHAN,23,1,22,23,20,3,23,6,0,7,10
2020-04-06,PULO GADUNG,56,4,52,32,22,10,25,11,0,3,11
2020-04-06,SAWAH BESAR,11,3,8,9,8,1,6,2,0,2,2
2020-04-06,SENEN,39,16,23,13,12,1,6,3,0,0,3
2020-04-06,SETIA BUDI,33,9,24,20,12,8,14,7,3,3,1
2020-04-06,TAMAN SARI,9,1,8,8,5,3,2,2,0,0,0
2020-04-06,TAMBORA,10,2,8,4,4,0,4,3,0,1,0
2020-04-06,TANAH ABANG,42,13,29,39,24,15,11,5,2,1,3
2020-04-06,TANJUNG PRIOK,62,39,23,35,29,6,16,7,2,2,5
2020-04-06,TEBET,23,3,20,24,16,8,38,24,1,3,10
2020-04-07,BELUM DIKETAHUI,1017,86,931,1031,143,888,363,349,3,5,6
2020-04-07,CAKUNG,22,6,16,31,21,10,16,11,1,3,1
2020-04-07,CEMPAKA PUTIH,18,4,14,10,7,3,11,6,1,1,3
2020-04-07,CENGKARENG,31,8,23,11,7,4,17,8,0,3,6
2020-04-07,CILANDAK,44,8,36,45,28,17,29,13,3,5,8
2020-04-07,CILINCING,43,10,33,21,17,4,3,1,0,2,0
2020-04-07,CIPAYUNG,31,10,21,20,19,1,9,6,2,0,1
2020-04-07,CIRACAS,21,5,16,17,12,5,10,4,1,3,2
2020-04-07,DUREN SAWIT,44,8,36,24,19,5,48,28,0,9,11
2020-04-07,GAMBIR,16,5,11,18,15,3,7,2,0,3,2
2020-04-07,GROGOL PETAMBURAN,35,18,17,34,27,7,34,23,2,4,5
2020-04-07,JAGAKARSA,25,3,22,27,17,10,22,13,0,1,8
2020-04-07,JATINEGARA,19,7,12,14,10,4,24,11,0,1,12
2020-04-07,JOHAR BARU,10,4,6,7,6,1,10,5,2,2,1
2020-04-07,KALI DERES,27,5,22,30,25,5,47,24,1,4,18
2020-04-07,KEBAYORAN BARU,31,6,25,41,32,9,36,12,3,3,18
2020-04-07,KEBAYORAN LAMA,40,9,31,32,22,10,38,20,3,5,10
2020-04-07,KEBON JERUK,18,2,16,45,34,11,47,20,7,3,17
2020-04-07,KELAPA GADING,88,64,24,31,28,3,32,12,6,6,8
2020-04-07,KEMAYORAN,24,7,17,21,17,4,14,10,0,1,3
2020-04-07,KEMBANGAN,32,13,19,35,28,7,27,13,4,1,9
2020-04-07,KEP. SERIBU SELATAN,0,0,0,0,0,0,0,0,0,0,0
2020-04-07,KEP. SERIBU UTARA,0,0,0,0,0,0,0,0,0,0,0
2020-04-07,KOJA,39,7,32,21,19,2,11,7,1,1,2
2020-04-07,KRAMAT JATI,26,9,17,27,19,8,17,3,1,2,11
2020-04-07,LUAR DKI JAKARTA,318,75,243,214,153,61,212,117,7,18,70
2020-04-07,MAKASAR,14,4,10,15,7,8,18,9,0,1,8
2020-04-07,MAMPANG PRAPATAN,24,8,16,16,9,7,15,5,3,3,4
2020-04-07,MATRAMAN,39,8,31,20,14,6,25,7,1,2,15
2020-04-07,MENTENG,17,9,8,11,8,3,12,4,1,5,2
2020-04-07,PADEMANGAN,17,6,11,6,5,1,6,4,0,2,0
2020-04-07,PALMERAH,18,4,14,18,16,2,21,13,0,1,7
2020-04-07,PANCORAN,18,3,15,15,9,6,7,5,1,0,1
2020-04-07,PASAR MINGGU,34,6,28,30,15,15,20,12,4,1,3
2020-04-07,PASAR REBO,12,4,8,18,13,5,10,3,2,3,2
2020-04-07,PENJARINGAN,49,10,39,32,21,11,20,12,1,4,3
2020-04-07,PESANGGRAHAN,23,1,22,24,21,3,23,6,0,7,10
2020-04-07,PULO GADUNG,57,5,52,39,27,12,27,12,0,4,11
2020-04-07,SAWAH BESAR,12,3,9,13,12,1,6,2,0,2,2
2020-04-07,SENEN,39,16,23,15,14,1,8,5,0,0,3
2020-04-07,SETIA BUDI,33,9,24,22,13,9,16,7,3,4,2
2020-04-07,TAMAN SARI,9,1,8,13,10,3,2,2,0,0,0
2020-04-07,TAMBORA,10,2,8,9,9,0,5,4,0,1,0
2020-04-07,TANAH ABANG,45,13,32,42,27,15,14,5,2,2,5
2020-04-07,TANJUNG PRIOK,64,41,23,36,30,6,16,7,2,2,5
2020-04-07,TEBET,24,3,21,27,19,8,40,25,1,3,11
2020-04-08,BELUM DIKETAHUI,1020,87,933,1032,144,888,451,418,3,6,24
2020-04-08,CAKUNG,23,6,17,31,21,10,16,11,1,3,1
2020-04-08,CEMPAKA PUTIH,19,5,14,10,7,3,12,6,2,2,2
2020-04-08,CENGKARENG,31,8,23,12,7,5,22,11,0,3,8
2020-04-08,CILANDAK,44,8,36,45,28,17,31,13,4,7,7
2020-04-08,CILINCING,45,11,34,21,17,4,4,1,0,2,1
2020-04-08,CIPAYUNG,33,10,23,20,19,1,8,5,2,0,1
2020-04-08,CIRACAS,21,5,16,17,12,5,10,4,1,3,2
2020-04-08,DUREN SAWIT,44,8,36,24,19,5,52,31,1,9,11
2020-04-08,GAMBIR,16,5,11,18,15,3,8,3,0,3,2
2020-04-08,GROGOL PETAMBURAN,35,18,17,34,27,7,34,23,2,4,5
2020-04-08,JAGAKARSA,25,3,22,29,18,11,24,15,0,1,8
2020-04-08,JATINEGARA,19,7,12,14,10,4,26,12,0,1,13
2020-04-08,JOHAR BARU,10,4,6,7,6,1,10,5,2,2,1
2020-04-08,KALI DERES,27,5,22,30,25,5,51,25,1,5,20
2020-04-08,KEBAYORAN BARU,31,6,25,41,32,9,36,12,3,3,18
2020-04-08,KEBAYORAN LAMA,40,9,31,32,22,10,39,20,3,6,10
2020-04-08,KEBON JERUK,18,2,16,45,34,11,47,20,7,3,17
2020-04-08,KELAPA GADING,88,64,24,32,28,4,36,13,6,6,11
2020-04-08,KEMAYORAN,24,7,17,22,17,5,15,10,0,1,4
2020-04-08,KEMBANGAN,33,13,20,36,28,8,30,14,4,2,10
2020-04-08,KEP. SERIBU SELATAN,0,0,0,0,0,0,0,0,0,0,0
2020-04-08,KEP. SERIBU UTARA,4,4,0,8,3,5,0,0,0,0,0
2020-04-08,KOJA,39,7,32,21,19,2,14,9,1,1,3
2020-04-08,KRAMAT JATI,26,9,17,27,19,8,17,2,2,2,11
2020-04-08,LUAR DKI JAKARTA,319,74,245,217,154,63,226,123,7,22,74
2020-04-08,MAKASAR,14,4,10,16,7,9,19,10,0,1,8
2020-04-08,MAMPANG PRAPATAN,24,8,16,16,9,7,15,5,3,3,4
2020-04-08,MATRAMAN,39,8,31,20,14,6,25,7,1,2,15
2020-04-08,MENTENG,17,9,8,12,9,3,13,5,1,5,2
2020-04-08,PADEMANGAN,17,6,11,7,6,1,6,4,0,2,0
2020-04-08,PALMERAH,19,5,14,18,16,2,21,13,0,1,7
2020-04-08,PANCORAN,18,3,15,16,9,7,7,5,1,0,1
2020-04-08,PASAR MINGGU,35,7,28,30,15,15,22,14,4,1,3
2020-04-08,PASAR REBO,13,5,8,18,13,5,12,5,2,3,2
2020-04-08,PENJARINGAN,49,10,39,32,21,11,28,20,1,4,3
2020-04-08,PESANGGRAHAN,23,1,22,24,21,3,23,6,0,7,10
2020-04-08,PULO GADUNG,57,5,52,40,28,12,27,12,0,4,11
2020-04-08,SAWAH BESAR,12,3,9,14,13,1,8,3,0,2,3
2020-04-08,SENEN,40,16,24,16,14,2,8,5,0,0,3
2020-04-08,SETIA BUDI,33,9,24,22,13,9,18,8,3,5,2
2020-04-08,TAMAN SARI,10,1,9,13,10,3,2,2,0,0,0
2020-04-08,TAMBORA,10,2,8,9,9,0,5,4,0,1,0
2020-04-08,TANAH ABANG,46,13,33,42,27,15,15,8,2,1,4
2020-04-08,TANJUNG PRIOK,64,41,23,37,31,6,18,9,2,2,5
2020-04-08,TEBET,24,3,21,27,19,8,41,25,3,3,10
2020-04-09,BELUM DIKETAHUI,1020,87,933,1028,143,885,441,426,4,3,8
2020-04-09,CAKUNG,26,6,20,32,21,11,16,11,1,3,1
2020-04-09,CEMPAKA PUTIH,21,5,16,10,7,3,14,7,2,2,3
2020-04-09,CENGKARENG,32,8,24,12,7,5,22,11,0,3,8
2020-04-09,CILANDAK,46,8,38,46,28,18,33,14,5,7,7
2020-04-09,CILINCING,47,11,36,21,17,4,4,1,0,2,1
2020-04-09,CIPAYUNG,35,10,25,20,19,1,8,5,2,0,1
2020-04-09,CIRACAS,21,5,16,17,12,5,12,4,1,4,3
2020-04-09,DUREN SAWIT,45,8,37,24,19,5,61,33,1,10,17
2020-04-09,GAMBIR,17,5,12,18,15,3,8,3,0,3,2
2020-04-09,GROGOL PETAMBURAN,35,18,17,34,27,7,35,23,2,5,5
2020-04-09,JAGAKARSA,26,3,23,31,19,12,27,18,0,1,8
2020-04-09,JATINEGARA,20,7,13,15,11,4,26,12,0,1,13
2020-04-09,JOHAR BARU,10,4,6,7,6,1,10,5,2,2,1
2020-04-09,KALI DERES,27,5,22,31,24,7,53,26,1,5,21
2020-04-09,KEBAYORAN BARU,31,6,25,41,32,9,36,12,3,3,18
2020-04-09,KEBAYORAN LAMA,41,9,32,32,22,10,40,20,3,6,11
2020-04-09,KEBON JERUK,19,2,17,45,34,11,49,21,7,3,18
2020-04-09,KELAPA GADING,88,64,24,32,28,4,40,15,6,6,13
2020-04-09,KEMAYORAN,27,7,20,22,17,5,21,11,1,1,8
2020-04-09,KEMBANGAN,33,13,20,36,28,8,31,14,4,2,11
2020-04-09,KEP. SERIBU SELATAN,25,0,25,4,0,4,0,0,0,0,0
2020-04-09,KEP. SERIBU UTARA,88,5,83,8,3,5,0,0,0,0,0
2020-04-09,KOJA,41,7,34,21,19,2,15,10,1,1,3
2020-04-09,KRAMAT JATI,27,9,18,28,20,8,20,2,3,2,13
2020-04-09,LUAR DKI JAKARTA,334,74,260,234,155,79,244,132,7,22,83
2020-04-09,MAKASAR,16,4,12,16,7,9,21,10,0,2,9
2020-04-09,MAMPANG PRAPATAN,25,8,17,16,9,7,15,5,3,3,4
2020-04-09,MATRAMAN,41,9,32,20,14,6,28,8,1,3,16
2020-04-09,MENTENG,18,9,9,14,10,4,14,6,2,5,1
2020-04-09,PADEMANGAN,17,6,11,7,6,1,6,4,0,2,0
2020-04-09,PALMERAH,19,5,14,18,16,2,22,14,0,1,7
2020-04-09,PANCORAN,18,3,15,17,9,8,8,6,1,0,1
2020-04-09,PASAR MINGGU,38,8,30,32,16,16,24,15,4,2,3
2020-04-09,PASAR REBO,15,5,10,19,13,6,15,6,2,3,4
2020-04-09,PENJARINGAN,49,10,39,33,21,12,28,20,1,4,3
2020-04-09,PESANGGRAHAN,23,1,22,24,21,3,26,7,0,7,12
2020-04-09,PULO GADUNG,59,5,54,43,30,13,28,13,1,4,10
2020-04-09,SAWAH BESAR,12,3,9,14,13,1,10,4,0,2,4
2020-04-09,SENEN,41,16,25,16,14,2,8,5,0,0,3
2020-04-09,SETIA BUDI,34,9,25,22,13,9,18,8,3,5,2
2020-04-09,TAMAN SARI,12,1,11,13,10,3,3,2,0,0,1
2020-04-09,TAMBORA,10,2,8,9,9,0,6,4,1,1,0
2020-04-09,TANAH ABANG,47,13,34,41,26,15,18,10,2,2,4
2020-04-09,TANJUNG PRIOK,72,41,31,38,31,7,24,14,2,3,5
2020-04-09,TEBET,25,3,22,28,19,9,44,27,3,3,11
2020-04-10,BELUM DIKETAHUI,1046,91,955,1041,156,885,704,588,10,21,85
2020-04-10,CAKUNG,26,6,20,35,24,11,17,11,1,3,2
2020-04-10,CEMPAKA PUTIH,21,5,16,12,9,3,18,10,2,3,3
2020-04-10,CENGKARENG,34,8,26,12,7,5,22,10,0,4,8
2020-04-10,CILANDAK,48,8,40,47,28,19,33,14,5,7,7
2020-04-10,CILINCING,49,11,38,21,17,4,6,1,0,3,2
2020-04-10,CIPAYUNG,37,11,26,21,20,1,11,6,2,0,3
2020-04-10,CIRACAS,22,5,17,17,12,5,13,4,1,4,4
2020-04-10,DUREN SAWIT,46,8,38,26,21,5,61,32,1,10,18
2020-04-10,GAMBIR,19,5,14,18,15,3,9,3,0,3,3
2020-04-10,GROGOL PETAMBURAN,35,18,17,35,28,7,38,25,2,5,6
2020-04-10,JAGAKARSA,29,3,26,31,19,12,27,18,0,1,8
2020-04-10,JATINEGARA,21,7,14,17,13,4,28,13,0,1,14
2020-04-10,JOHAR BARU,11,4,7,10,9,1,12,5,2,2,3
2020-04-10,KALI DERES,27,5,22,31,24,7,54,27,1,5,21
2020-04-10,KEBAYORAN BARU,37,6,31,41,32,9,38,14,3,3,18
2020-04-10,KEBAYORAN LAMA,44,9,35,34,23,11,43,22,3,6,12
2020-04-10,KEBON JERUK,21,4,17,46,35,11,51,22,7,3,19
2020-04-10,KELAPA GADING,89,64,25,33,29,4,40,15,6,6,13
2020-04-10,KEMAYORAN,27,7,20,25,20,5,22,11,1,1,9
2020-04-10,KEMBANGAN,36,13,23,36,28,8,32,15,4,2,11
2020-04-10,KEP. SERIBU SELATAN,25,0,25,4,0,4,0,0,0,0,0
2020-04-10,KEP. SERIBU UTARA,88,5,83,8,3,5,0,0,0,0,0
2020-04-10,KOJA,44,7,37,24,22,2,20,11,1,1,7
2020-04-10,KRAMAT JATI,28,10,18,28,20,8,27,7,3,2,15
2020-04-10,LUAR DKI JAKARTA,318,72,246,238,158,80,81,43,1,6,31
2020-04-10,MAKASAR,16,4,12,17,8,9,24,12,0,2,10
2020-04-10,MAMPANG PRAPATAN,50,8,42,19,10,9,17,6,3,3,5
2020-04-10,MATRAMAN,46,10,36,22,16,6,28,8,1,3,16
2020-04-10,MENTENG,18,9,9,14,10,4,14,6,2,5,1
2020-04-10,PADEMANGAN,17,6,11,7,6,1,6,4,0,2,0
2020-04-10,PALMERAH,20,5,15,19,17,2,23,14,0,1,8
2020-04-10,PANCORAN,23,3,20,19,9,10,8,6,1,0,1
2020-04-10,PASAR MINGGU,39,9,30,33,17,16,29,19,4,3,3
2020-04-10,PASAR REBO,16,6,10,20,14,6,17,6,2,3,6
2020-04-10,PENJARINGAN,50,11,39,34,22,12,29,20,1,4,4
2020-04-10,PESANGGRAHAN,26,1,25,24,21,3,35,13,0,7,15
2020-04-10,PULO GADUNG,61,5,56,45,32,13,32,15,1,4,12
2020-04-10,SAWAH BESAR,12,3,9,15,14,1,10,4,0,2,4
2020-04-10,SENEN,41,16,25,17,15,2,9,5,0,0,4
2020-04-10,SETIA BUDI,36,10,26,24,15,9,21,11,3,5,2
2020-04-10,TAMAN SARI,12,1,11,13,10,3,3,2,0,0,1
2020-04-10,TAMBORA,11,2,9,9,9,0,7,4,1,1,1
2020-04-10,TANAH ABANG,49,14,35,45,30,15,18,10,2,2,4
2020-04-10,TANJUNG PRIOK,73,41,32,38,31,7,25,15,2,3,5
2020-04-10,TEBET,28,3,25,28,19,9,48,30,3,4,11
2020-04-11,BELUM DIKETAHUI,1024,91,933,1043,158,885,725,599,18,26,82
2020-04-11,CAKUNG,26,6,20,35,24,11,19,11,3,3,2
2020-04-11,CEMPAKA PUTIH,21,5,16,12,9,3,23,11,3,3,6
2020-04-11,CENGKARENG,34,8,26,13,8,5,24,10,1,4,9
2020-04-11,CILANDAK,52,8,44,48,28,20,37,14,8,7,8
2020-04-11,CILINCING,49,11,38,22,17,5,9,2,0,3,4
2020-04-11,CIPAYUNG,37,11,26,22,21,1,11,6,2,0,3
2020-04-11,CIRACAS,22,5,17,17,12,5,13,3,2,4,4
2020-04-11,DUREN SAWIT,48,9,39,28,23,5,65,33,2,10,20
2020-04-11,GAMBIR,19,5,14,19,16,3,10,3,0,3,4
2020-04-11,GROGOL PETAMBURAN,35,18,17,35,28,7,38,23,5,5,5
2020-04-11,JAGAKARSA,31,3,28,33,20,13,28,17,2,1,8
2020-04-11,JATINEGARA,21,7,14,18,14,4,30,15,0,1,14
2020-04-11,JOHAR BARU,11,4,7,11,10,1,12,5,2,2,3
2020-04-11,KALI DERES,27,5,22,31,24,7,54,24,5,5,20
2020-04-11,KEBAYORAN BARU,37,6,31,41,32,9,38,14,8,3,13
2020-04-11,KEBAYORAN LAMA,47,9,38,34,23,11,45,20,7,6,12
2020-04-11,KEBON JERUK,21,4,17,47,36,11,53,23,8,3,19
2020-04-11,KELAPA GADING,89,64,25,35,31,4,41,15,7,6,13
2020-04-11,KEMAYORAN,27,7,20,25,20,5,25,10,2,2,11
2020-04-11,KEMBANGAN,36,13,23,36,28,8,32,14,8,2,8
2020-04-11,KEP. SERIBU SELATAN,25,0,25,4,0,4,0,0,0,0,0
2020-04-11,KEP. SERIBU UTARA,88,5,83,8,3,5,0,0,0,0,0
2020-04-11,KOJA,45,7,38,24,22,2,20,11,1,1,7
2020-04-11,KRAMAT JATI,29,10,19,28,20,8,30,9,4,2,15
2020-04-11,LUAR DKI JAKARTA,325,74,251,241,161,80,90,46,2,7,35
2020-04-11,MAKASAR,16,4,12,18,9,9,24,12,0,2,10
2020-04-11,MAMPANG PRAPATAN,50,8,42,19,10,9,17,5,4,3,5
2020-04-11,MATRAMAN,46,10,36,23,17,6,28,7,2,3,16
2020-04-11,MENTENG,18,9,9,14,10,4,19,9,3,6,1
2020-04-11,PADEMANGAN,17,6,11,7,6,1,10,5,0,2,3
2020-04-11,PALMERAH,20,5,15,19,17,2,23,14,0,1,8
2020-04-11,PANCORAN,23,3,20,19,9,10,11,7,2,0,2
2020-04-11,PASAR MINGGU,40,9,31,33,17,16,30,18,5,4,3
2020-04-11,PASAR REBO,16,6,10,20,14,6,17,6,2,3,6
2020-04-11,PENJARINGAN,50,11,39,35,22,13,30,20,2,4,4
2020-04-11,PESANGGRAHAN,26,1,25,24,21,3,38,15,4,8,11
2020-04-11,PULO GADUNG,63,6,57,45,32,13,34,16,1,5,12
2020-04-11,SAWAH BESAR,12,3,9,15,14,1,12,4,0,2,6
2020-04-11,SENEN,42,16,26,17,15,2,11,7,0,0,4
2020-04-11,SETIA BUDI,36,10,26,26,17,9,21,8,6,5,2
2020-04-11,TAMAN SARI,12,1,11,13,10,3,3,2,0,0,1
2020-04-11,TAMBORA,11,2,9,9,9,0,8,4,1,1,2
2020-04-11,TANAH ABANG,49,14,35,45,30,15,19,9,4,3,3
2020-04-11,TANJUNG PRIOK,72,40,32,40,32,8,28,16,3,3,6
2020-04-11,TEBET,28,3,25,28,19,9,48,30,3,4,11
2020-04-12,BELUM DIKETAHUI,1004,88,916,1028,153,875,610,579,5,15,11
2020-04-12,CAKUNG,26,6,20,36,23,13,21,13,3,3,2
2020-04-12,CEMPAKA PUTIH,21,5,16,12,9,3,24,12,3,3,6
2020-04-12,CENGKARENG,34,8,26,14,8,6,27,13,1,4,9
2020-04-12,CILANDAK,52,8,44,49,29,20,38,15,8,7,8
2020-04-12,CILINCING,50,11,39,22,17,5,11,2,0,4,5
2020-04-12,CIPAYUNG,38,11,27,24,22,2,12,8,2,0,2
2020-04-12,CIRACAS,23,5,18,18,12,6,13,3,2,4,4
2020-04-12,DUREN SAWIT,48,8,40,28,23,5,67,34,2,11,20
2020-04-12,GAMBIR,19,5,14,19,16,3,15,5,0,4,6
2020-04-12,GROGOL PETAMBURAN,35,18,17,35,28,7,39,23,5,5,6
2020-04-12,JAGAKARSA,33,3,30,33,20,13,30,17,2,2,9
2020-04-12,JATINEGARA,21,7,14,18,14,4,32,15,0,3,14
2020-04-12,JOHAR BARU,11,4,7,12,11,1,13,6,2,2,3
2020-04-12,KALI DERES,27,5,22,32,25,7,60,27,5,5,23
2020-04-12,KEBAYORAN BARU,37,6,31,41,32,9,39,15,8,3,13
2020-04-12,KEBAYORAN LAMA,47,9,38,34,23,11,48,22,7,7,12
2020-04-12,KEBON JERUK,20,3,17,46,35,11,55,25,8,3,19
2020-04-12,KELAPA GADING,89,64,25,35,31,4,44,17,7,6,14
2020-04-12,KEMAYORAN,29,8,21,25,20,5,29,11,2,2,14
2020-04-12,KEMBANGAN,36,13,23,36,28,8,33,15,8,2,8
2020-04-12,KEP. SERIBU SELATAN,25,0,25,4,0,4,0,0,0,0,0
2020-04-12,KEP. SERIBU UTARA,88,5,83,8,3,5,0,0,0,0,0
2020-04-12,KOJA,48,8,40,25,23,2,20,10,1,1,8
2020-04-12,KRAMAT JATI,29,10,19,30,21,9,31,10,4,3,14
2020-04-12,LUAR DKI JAKARTA,351,76,275,250,169,81,312,158,15,27,112
2020-04-12,MAKASAR,16,4,12,18,9,9,26,13,0,3,10
2020-04-12,MAMPANG PRAPATAN,50,8,42,20,10,10,17,5,4,3,5
2020-04-12,MATRAMAN,46,10,36,23,17,6,28,7,2,3,16
2020-04-12,MENTENG,18,9,9,14,10,4,21,10,3,6,2
2020-04-12,PADEMANGAN,17,6,11,7,6,1,10,4,0,2,4
2020-04-12,PALMERAH,20,5,15,19,17,2,23,14,0,1,8
2020-04-12,PANCORAN,24,3,21,19,9,10,12,5,2,2,3
2020-04-12,PASAR MINGGU,41,9,32,32,16,16,33,19,5,5,4
2020-04-12,PASAR REBO,17,7,10,20,14,6,17,6,2,3,6
2020-04-12,PENJARINGAN,50,11,39,36,23,13,30,20,2,4,4
2020-04-12,PESANGGRAHAN,28,2,26,25,22,3,32,12,4,9,7
2020-04-12,PULO GADUNG,64,7,57,46,32,14,40,19,1,6,14
2020-04-12,SAWAH BESAR,12,3,9,15,14,1,12,3,0,3,6
2020-04-12,SENEN,42,16,26,18,16,2,11,7,0,0,4
2020-04-12,SETIA BUDI,37,10,27,29,19,10,23,10,6,5,2
2020-04-12,TAMAN SARI,12,1,11,13,10,3,5,3,0,1,1
2020-04-12,TAMBORA,11,2,9,10,10,0,9,5,1,2,1
2020-04-12,TANAH ABANG,49,15,34,45,30,15,31,13,4,3,11
2020-04-12,TANJUNG PRIOK,72,40,32,41,33,8,30,16,3,4,7
2020-04-12,TEBET,30,3,27,30,19,11,49,31,3,4,11
2020-04-13,BELUM DIKETAHUI,1003,88,915,1024,150,874,673,639,4,13,17
2020-04-13,CAKUNG,26,6,20,38,23,15,26,13,3,4,6
2020-04-13,CEMPAKA PUTIH,21,5,16,12,8,4,26,12,4,3,7
2020-04-13,CENGKARENG,34,8,26,15,8,7,30,14,1,5,10
2020-04-13,CILANDAK,52,8,44,50,29,21,39,16,8,7,8
2020-04-13,CILINCING,51,12,39,21,15,6,14,3,0,4,7
2020-04-13,CIPAYUNG,39,11,28,26,22,4,15,8,2,0,5
2020-04-13,CIRACAS,23,5,18,20,13,7,14,3,2,4,5
2020-04-13,DUREN SAWIT,48,8,40,28,23,5,68,35,2,11,20
2020-04-13,GAMBIR,19,5,14,19,16,3,15,5,0,4,6
2020-04-13,GROGOL PETAMBURAN,35,18,17,35,28,7,40,23,5,5,7
2020-04-13,JAGAKARSA,34,4,30,33,20,13,31,18,2,2,9
2020-04-13,JATINEGARA,21,7,14,18,14,4,41,21,0,5,15
2020-04-13,JOHAR BARU,11,4,7,12,11,1,16,6,2,4,4
2020-04-13,KALI DERES,27,5,22,32,25,7,60,27,5,5,23
2020-04-13,KEBAYORAN BARU,41,6,35,41,32,9,39,15,8,3,13
2020-04-13,KEBAYORAN LAMA,49,10,39,34,23,11,48,20,7,8,13
2020-04-13,KEBON JERUK,20,3,17,46,35,11,56,26,8,3,19
2020-04-13,KELAPA GADING,89,64,25,36,32,4,47,19,7,6,15
2020-04-13,KEMAYORAN,29,8,21,25,20,5,31,10,2,2,17
2020-04-13,KEMBANGAN,36,13,23,36,28,8,33,15,8,2,8
2020-04-13,KEP. SERIBU SELATAN,25,0,25,4,0,4,0,0,0,0,0
2020-04-13,KEP. SERIBU UTARA,88,5,83,8,3,5,0,0,0,0,0
2020-04-13,KOJA,49,9,40,27,24,3,20,10,1,1,8
2020-04-13,KRAMAT JATI,29,10,19,31,21,10,33,11,4,3,15
2020-04-13,LUAR DKI JAKARTA,356,80,276,251,169,82,339,166,15,29,129
2020-04-13,MAKASAR,16,4,12,18,9,9,28,14,0,3,11
2020-04-13,MAMPANG PRAPATAN,50,8,42,20,10,10,18,5,4,3,6
2020-04-13,MATRAMAN,47,10,37,24,18,6,29,7,2,3,17
2020-04-13,MENTENG,19,9,10,14,10,4,21,10,3,6,2
2020-04-13,PADEMANGAN,17,6,11,8,7,1,10,4,0,2,4
2020-04-13,PALMERAH,20,5,15,19,17,2,23,14,0,1,8
2020-04-13,PANCORAN,24,3,21,19,9,10,13,6,2,2,3
2020-04-13,PASAR MINGGU,41,9,32,33,16,17,37,21,5,7,4
2020-04-13,PASAR REBO,17,7,10,20,14,6,18,6,2,3,7
2020-04-13,PENJARINGAN,52,12,40,36,23,13,33,21,2,4,6
2020-04-13,PESANGGRAHAN,28,2,26,25,22,3,35,14,4,10,7
2020-04-13,PULO GADUNG,64,7,57,46,32,14,44,20,1,7,16
2020-04-13,SAWAH BESAR,12,3,9,15,14,1,12,3,0,3,6
2020-04-13,SENEN,42,16,26,18,16,2,13,8,0,1,4
2020-04-13,SETIA BUDI,37,10,27,29,18,11,23,10,6,5,2
2020-04-13,TAMAN SARI,12,1,11,13,10,3,8,6,0,1,1
2020-04-13,TAMBORA,11,2,9,10,10,0,9,5,1,2,1
2020-04-13,TANAH ABANG,51,16,35,45,30,15,34,15,4,4,11
2020-04-13,TANJUNG PRIOK,72,40,32,41,31,10,30,14,3,5,8
2020-04-13,TEBET,30,3,27,30,19,11,50,32,3,4,11
2020-04-14,BELUM DIKETAHUI,1023,90,933,1028,153,875,701,645,4,25,27
2020-04-14,CAKUNG,28,6,22,40,25,15,30,16,3,4,7
2020-04-14,CEMPAKA PUTIH,21,5,16,12,8,4,28,13,4,5,6
2020-04-14,CENGKARENG,34,8,26,15,8,7,33,16,1,5,11
2020-04-14,CILANDAK,55,8,47,50,29,21,44,17,8,9,10
2020-04-14,CILINCING,52,12,40,23,16,7,14,3,0,4,7
2020-04-14,CIPAYUNG,41,11,30,27,22,5,17,9,2,0,6
2020-04-14,CIRACAS,25,5,20,20,13,7,16,4,2,5,5
2020-04-14,DUREN SAWIT,50,8,42,30,25,5,71,36,3,12,20
2020-04-14,GAMBIR,20,5,15,20,16,4,15,5,0,4,6
2020-04-14,GROGOL PETAMBURAN,37,18,19,36,29,7,42,21,7,6,8
2020-04-14,JAGAKARSA,35,4,31,33,20,13,31,17,2,2,10
2020-04-14,JATINEGARA,22,8,14,18,14,4,45,23,1,5,16
2020-04-14,JOHAR BARU,11,4,7,13,12,1,17,6,2,4,5
2020-04-14,KALI DERES,27,5,22,34,26,8,61,23,9,6,23
2020-04-14,KEBAYORAN BARU,43,6,37,41,32,9,39,15,9,3,12
2020-04-14,KEBAYORAN LAMA,49,10,39,35,24,11,49,19,7,10,13
2020-04-14,KEBON JERUK,22,4,18,49,38,11,56,25,10,3,18
2020-04-14,KELAPA GADING,94,67,27,36,32,4,50,19,7,7,17
2020-04-14,KEMAYORAN,31,9,22,26,21,5,33,9,2,3,19
2020-04-14,KEMBANGAN,37,13,24,36,28,8,33,14,9,2,8
2020-04-14,KEP. SERIBU SELATAN,25,0,25,4,0,4,0,0,0,0,0
2020-04-14,KEP. SERIBU UTARA,88,5,83,8,3,5,0,0,0,0,0
2020-04-14,KOJA,50,9,41,27,24,3,21,11,1,1,8
2020-04-14,KRAMAT JATI,30,10,20,31,21,10,40,10,4,4,22
2020-04-14,LUAR DKI JAKARTA,342,77,265,254,169,85,332,162,20,32,118
2020-04-14,MAKASAR,16,4,12,19,10,9,29,13,1,4,11
2020-04-14,MAMPANG PRAPATAN,51,8,43,20,10,10,18,5,4,3,6
2020-04-14,MATRAMAN,49,10,39,25,18,7,29,6,3,3,17
2020-04-14,MENTENG,19,9,10,14,10,4,23,11,3,7,2
2020-04-14,PADEMANGAN,18,6,12,8,7,1,23,4,0,2,17
2020-04-14,PALMERAH,24,6,18,19,17,2,24,14,1,1,8
2020-04-14,PANCORAN,26,3,23,21,10,11,14,7,2,2,3
2020-04-14,PASAR MINGGU,41,9,32,34,17,17,39,21,5,8,5
2020-04-14,PASAR REBO,18,8,10,21,14,7,19,6,2,3,8
2020-04-14,PENJARINGAN,52,12,40,38,24,14,33,21,2,4,6
2020-04-14,PESANGGRAHAN,32,2,30,25,22,3,44,17,4,13,10
2020-04-14,PULO GADUNG,65,7,58,47,33,14,49,25,2,7,15
2020-04-14,SAWAH BESAR,12,3,9,17,14,3,12,3,0,3,6
2020-04-14,SENEN,43,16,27,18,16,2,13,8,0,1,4
2020-04-14,SETIA BUDI,39,10,29,30,18,12,25,12,6,5,2
2020-04-14,TAMAN SARI,12,1,11,13,10,3,10,6,0,1,3
2020-04-14,TAMBORA,11,2,9,11,11,0,10,5,1,2,2
2020-04-14,TANAH ABANG,51,16,35,47,32,15,35,16,4,4,11
2020-04-14,TANJUNG PRIOK,75,40,35,41,31,10,30,14,3,5,8
2020-04-14,TEBET,31,3,28,32,20,12,52,33,3,4,12
2020-04-15,BELUM DIKETAHUI,1004,88,916,1026,151,875,709,659,4,22,24
2020-04-15,CAKUNG,29,6,23,39,24,15,30,16,3,5,6
2020-04-15,CEMPAKA PUTIH,21,5,16,12,8,4,30,13,4,5,8
2020-04-15,CENGKARENG,34,8,26,15,8,7,34,17,1,5,11
2020-04-15,CILANDAK,56,8,48,50,29,21,49,20,8,11,10
2020-04-15,CILINCING,52,12,40,24,17,7,15,3,0,4,8
2020-04-15,CIPAYUNG,43,11,32,29,23,6,17,9,2,0,6
2020-04-15,CIRACAS,25,5,20,20,13,7,16,4,2,5,5
2020-04-15,DUREN SAWIT,51,8,43,30,25,5,74,37,3,12,22
2020-04-15,GAMBIR,20,5,15,20,16,4,15,5,0,4,6
2020-04-15,GROGOL PETAMBURAN,39,18,21,36,29,7,43,21,7,7,8
2020-04-15,JAGAKARSA,35,4,31,33,20,13,32,17,2,2,11
2020-04-15,JATINEGARA,24,8,16,18,14,4,44,22,1,5,16
2020-04-15,JOHAR BARU,11,4,7,13,12,1,17,6,2,4,5
2020-04-15,KALI DERES,27,5,22,34,26,8,61,23,9,6,23
2020-04-15,KEBAYORAN BARU,43,6,37,41,32,9,39,15,9,3,12
2020-04-15,KEBAYORAN LAMA,49,10,39,35,24,11,49,19,7,10,13
2020-04-15,KEBON JERUK,21,3,18,49,38,11,57,26,10,3,18
2020-04-15,KELAPA GADING,94,67,27,36,32,4,55,19,7,7,22
2020-04-15,KEMAYORAN,31,9,22,26,21,5,33,9,2,3,19
2020-04-15,KEMBANGAN,36,13,23,36,28,8,33,14,9,2,8
2020-04-15,KEP. SERIBU SELATAN,25,0,25,4,0,4,0,0,0,0,0
2020-04-15,KEP. SERIBU UTARA,88,5,83,8,3,5,0,0,0,0,0
2020-04-15,KOJA,52,10,42,28,25,3,22,12,1,1,8
2020-04-15,KRAMAT JATI,30,10,20,31,21,10,41,10,4,5,22
2020-04-15,LUAR DKI JAKARTA,365,81,284,261,176,85,350,169,20,33,128
2020-04-15,MAKASAR,16,4,12,19,10,9,27,12,1,4,10
2020-04-15,MAMPANG PRAPATAN,51,8,43,21,11,10,18,5,4,3,6
2020-04-15,MATRAMAN,49,10,39,25,18,7,33,7,3,3,20
2020-04-15,MENTENG,19,9,10,14,10,4,24,12,3,7,2
2020-04-15,PADEMANGAN,18,6,12,9,7,2,27,5,0,2,20
2020-04-15,PALMERAH,24,6,18,19,17,2,25,15,1,1,8
2020-04-15,PANCORAN,26,3,23,21,10,11,15,8,2,2,3
2020-04-15,PASAR MINGGU,41,9,32,33,16,17,40,22,5,8,5
2020-04-15,PASAR REBO,18,8,10,21,14,7,23,8,2,3,10
2020-04-15,PENJARINGAN,52,12,40,38,24,14,36,24,2,4,6
2020-04-15,PESANGGRAHAN,32,2,30,25,22,3,36,9,5,12,10
2020-04-15,PULO GADUNG,65,7,58,47,33,14,52,26,2,7,17
2020-04-15,SAWAH BESAR,12,3,9,17,14,3,12,3,0,3,6
2020-04-15,SENEN,43,16,27,18,16,2,16,8,0,1,7
2020-04-15,SETIA BUDI,39,10,29,30,18,12,25,12,6,5,2
2020-04-15,TAMAN SARI,12,1,11,14,10,4,14,11,0,1,2
2020-04-15,TAMBORA,11,2,9,11,11,0,11,6,1,2,2
2020-04-15,TANAH ABANG,51,16,35,46,31,15,60,16,4,5,35
2020-04-15,TANJUNG PRIOK,76,40,36,42,32,10,32,15,3,5,9
2020-04-15,TEBET,31,3,28,33,20,13,56,35,3,4,14
2020-04-16,BELUM DIKETAHUI,1032,88,944,1023,152,871,774,734,5,21,14
2020-04-16,CAKUNG,29,6,23,39,24,15,39,22,3,5,9
2020-04-16,CEMPAKA PUTIH,22,5,17,12,8,4,35,17,4,4,10
2020-04-16,CENGKARENG,34,8,26,15,8,7,38,20,2,5,11
2020-04-16,CILANDAK,56,8,48,51,30,21,51,21,8,11,11
2020-04-16,CILINCING,52,12,40,24,17,7,18,6,0,4,8
2020-04-16,CIPAYUNG,44,11,33,29,23,6,18,10,2,0,6
2020-04-16,CIRACAS,25,5,20,20,13,7,21,8,2,5,6
2020-04-16,DUREN SAWIT,51,8,43,30,25,5,80,41,3,12,24
2020-04-16,GAMBIR,20,5,15,20,16,4,15,5,0,4,6
2020-04-16,GROGOL PETAMBURAN,39,18,21,36,29,7,44,18,12,7,7
2020-04-16,JAGAKARSA,35,4,31,33,20,13,36,20,2,2,12
2020-04-16,JATINEGARA,24,8,16,18,14,4,45,22,0,5,18
2020-04-16,JOHAR BARU,11,4,7,13,12,1,20,8,3,5,4
2020-04-16,KALI DERES,27,5,22,34,26,8,61,22,11,6,22
2020-04-16,KEBAYORAN BARU,44,6,38,41,32,9,42,16,21,3,2
2020-04-16,KEBAYORAN LAMA,49,10,39,35,24,11,52,21,8,11,12
2020-04-16,KEBON JERUK,21,3,18,49,38,11,60,28,11,3,18
2020-04-16,KELAPA GADING,94,67,27,37,33,4,57,20,7,7,23
2020-04-16,KEMAYORAN,31,9,22,26,21,5,44,18,2,5,19
2020-04-16,KEMBANGAN,38,13,25,36,28,8,33,14,10,2,7
2020-04-16,KEP. SERIBU SELATAN,25,0,25,4,0,4,0,0,0,0,0
2020-04-16,KEP. SERIBU UTARA,88,5,83,8,3,5,0,0,0,0,0
2020-04-16,KOJA,52,10,42,29,26,3,23,13,1,1,8
2020-04-16,KRAMAT JATI,31,10,21,31,21,10,43,12,4,5,22
2020-04-16,LUAR DKI JAKARTA,371,81,290,263,177,86,385,194,27,33,131
2020-04-16,MAKASAR,17,4,13,20,11,9,27,12,2,4,9
2020-04-16,MAMPANG PRAPATAN,51,8,43,21,11,10,18,5,4,3,6
2020-04-16,MATRAMAN,50,10,40,25,18,7,37,10,3,3,21
2020-04-16,MENTENG,20,9,11,13,9,4,25,13,3,7,2
2020-04-16,PADEMANGAN,18,6,12,9,7,2,29,7,0,2,20
2020-04-16,PALMERAH,24,6,18,19,17,2,27,16,2,1,8
2020-04-16,PANCORAN,26,3,23,22,11,11,19,12,2,2,3
2020-04-16,PASAR MINGGU,42,9,33,33,16,17,40,22,6,8,4
2020-04-16,PASAR REBO,18,8,10,21,14,7,23,7,3,3,10
2020-04-16,PENJARINGAN,52,12,40,38,24,14,38,25,2,4,7
2020-04-16,PESANGGRAHAN,32,2,30,25,22,3,36,9,5,12,10
2020-04-16,PULO GADUNG,65,7,58,47,33,14,58,32,3,7,16
2020-04-16,SAWAH BESAR,12,3,9,17,14,3,14,3,1,3,7
2020-04-16,SENEN,44,16,28,21,16,5,19,10,0,1,8
2020-04-16,SETIA BUDI,39,10,29,30,18,12,26,13,6,5,2
2020-04-16,TAMAN SARI,12,1,11,14,10,4,21,17,0,1,3
2020-04-16,TAMBORA,11,2,9,11,11,0,11,6,1,2,2
2020-04-16,TANAH ABANG,52,16,36,46,31,15,72,16,4,5,47
2020-04-16,TANJUNG PRIOK,79,40,39,42,32,10,39,20,3,5,11
2020-04-16,TEBET,31,3,28,35,22,13,57,36,4,4,13
2020-04-17,BELUM DIKETAHUI,1232,91,1141,1073,172,901,806,749,6,22,29
2020-04-17,CAKUNG,35,7,28,47,30,17,44,24,4,5,11
2020-04-17,CEMPAKA PUTIH,44,5,39,25,16,9,38,20,4,4,10
2020-04-17,CENGKARENG,36,8,28,18,10,8,41,23,2,5,11
2020-04-17,CILANDAK,58,8,50,53,32,21,52,22,8,11,11
2020-04-17,CILINCING,58,12,46,27,19,8,18,6,0,4,8
2020-04-17,CIPAYUNG,48,11,37,29,23,6,19,10,2,0,7
2020-04-17,CIRACAS,30,5,25,21,14,7,23,10,2,5,6
2020-04-17,DUREN SAWIT,63,8,55,39,34,5,82,45,3,12,22
2020-04-17,GAMBIR,33,5,28,26,21,5,16,6,0,4,6
2020-04-17,GROGOL PETAMBURAN,44,18,26,38,29,9,52,22,12,7,11
2020-04-17,JAGAKARSA,38,4,34,34,21,13,36,20,2,2,12
2020-04-17,JATINEGARA,28,8,20,19,15,4,46,24,0,5,17
2020-04-17,JOHAR BARU,39,4,35,30,19,11,21,9,3,5,4
2020-04-17,KALI DERES,29,5,24,35,27,8,61,22,11,6,22
2020-04-17,KEBAYORAN BARU,49,6,43,46,35,11,44,18,21,3,2
2020-04-17,KEBAYORAN LAMA,54,10,44,36,25,11,52,21,8,11,12
2020-04-17,KEBON JERUK,30,4,26,54,41,13,61,29,11,3,18
2020-04-17,KELAPA GADING,98,67,31,48,41,7,59,22,7,7,23
2020-04-17,KEMAYORAN,65,13,52,69,45,24,73,48,2,5,18
2020-04-17,KEMBANGAN,42,13,29,38,29,9,36,16,10,2,8
2020-04-17,KEP. SERIBU SELATAN,25,0,25,4,0,4,0,0,0,0,0
2020-04-17,KEP. SERIBU UTARA,88,5,83,8,3,5,0,0,0,0,0
2020-04-17,KOJA,55,10,45,32,29,3,25,16,1,0,8
2020-04-17,KRAMAT JATI,35,10,25,32,22,10,43,12,4,5,22
2020-04-17,LUAR DKI JAKARTA,460,78,382,290,185,105,392,204,25,33,130
2020-04-17,MAKASAR,25,4,21,20,11,9,27,12,2,4,9
2020-04-17,MAMPANG PRAPATAN,52,8,44,22,12,10,19,6,4,3,6
2020-04-17,MATRAMAN,60,10,50,30,22,8,47,19,3,3,22
2020-04-17,MENTENG,31,9,22,23,15,8,26,14,3,7,2
2020-04-17,PADEMANGAN,24,6,18,21,13,8,32,10,0,2,20
2020-04-17,PALMERAH,35,6,29,23,18,5,27,16,2,1,8
2020-04-17,PANCORAN,28,3,25,27,14,13,21,14,2,2,3
2020-04-17,PASAR MINGGU,45,9,36,39,20,19,41,23,6,8,4
2020-04-17,PASAR REBO,21,8,13,22,15,7,23,7,3,3,10
2020-04-17,PENJARINGAN,54,12,42,41,25,16,40,27,2,4,7
2020-04-17,PESANGGRAHAN,34,2,32,27,22,5,44,13,5,13,13
2020-04-17,PULO GADUNG,90,8,82,56,39,17,58,32,3,7,16
2020-04-17,SAWAH BESAR,93,6,87,51,23,28,16,5,1,3,7
2020-04-17,SENEN,61,16,45,39,26,13,19,10,0,1,8
2020-04-17,SETIA BUDI,43,10,33,33,18,15,29,16,6,5,2
2020-04-17,TAMAN SARI,32,2,30,24,15,9,23,17,0,1,5
2020-04-17,TAMBORA,21,2,19,14,12,2,14,8,2,2,2
2020-04-17,TANAH ABANG,77,17,60,73,46,27,74,18,4,5,47
2020-04-17,TANJUNG PRIOK,100,40,60,74,48,26,44,24,3,6,11
2020-04-17,TEBET,37,3,34,35,22,13,59,38,4,4,13
2020-04-18,BELUM DIKETAHUI,2540,94,2446,2760,241,2519,738,692,7,21,18
2020-04-18,CAKUNG,36,7,29,47,30,17,47,27,4,5,11
2020-04-18,CEMPAKA PUTIH,40,5,35,25,16,9,38,20,4,4,10
2020-04-18,CENGKARENG,37,8,29,18,10,8,42,24,3,5,10
2020-04-18,CILANDAK,58,8,50,53,32,21,57,25,8,11,13
2020-04-18,CILINCING,58,12,46,28,20,8,19,7,0,4,8
2020-04-18,CIPAYUNG,50,11,39,29,23,6,24,15,2,0,7
2020-04-18,CIRACAS,30,5,25,21,14,7,23,10,2,5,6
2020-04-18,DUREN SAWIT,63,8,55,39,34,5,87,50,3,12,22
2020-04-18,GAMBIR,33,5,28,26,21,5,18,7,0,5,6
2020-04-18,GROGOL PETAMBURAN,44,18,26,38,29,9,57,27,12,7,11
2020-04-18,JAGAKARSA,38,4,34,34,21,13,43,25,2,3,13
2020-04-18,JATINEGARA,29,8,21,19,15,4,47,25,0,5,17
2020-04-18,JOHAR BARU,39,4,35,30,19,11,21,9,3,5,4
2020-04-18,KALI DERES,29,5,24,35,27,8,64,25,11,6,22
2020-04-18,KEBAYORAN BARU,49,6,43,46,35,11,44,17,21,3,3
2020-04-18,KEBAYORAN LAMA,54,10,44,36,25,11,56,24,8,12,12
2020-04-18,KEBON JERUK,30,4,26,55,41,14,64,30,11,3,20
2020-04-18,KELAPA GADING,99,46,53,47,40,7,64,24,8,7,25
2020-04-18,KEMAYORAN,65,13,52,69,45,24,44,13,2,7,22
2020-04-18,KEMBANGAN,42,13,29,39,30,9,40,18,10,2,10
2020-04-18,KEP. SERIBU SELATAN,25,0,25,4,0,4,0,0,0,0,0
2020-04-18,KEP. SERIBU UTARA,88,5,83,8,3,5,0,0,0,0,0
2020-04-18,KOJA,57,10,47,32,29,3,25,16,1,0,8
2020-04-18,KRAMAT JATI,35,10,25,32,22,10,45,13,4,5,23
2020-04-18,LUAR DKI JAKARTA,1043,79,964,886,206,680,434,241,25,34,134
2020-04-18,MAKASAR,26,5,21,20,11,9,28,13,2,4,9
2020-04-18,MAMPANG PRAPATAN,52,8,44,22,12,10,21,8,4,3,6
2020-04-18,MATRAMAN,60,10,50,30,22,8,50,22,3,3,22
2020-04-18,MENTENG,30,9,21,23,15,8,26,15,3,6,2
2020-04-18,PADEMANGAN,24,6,18,21,13,8,32,9,0,3,20
2020-04-18,PALMERAH,35,6,29,23,18,5,32,20,2,2,8
2020-04-18,PANCORAN,28,3,25,27,14,13,24,17,2,2,3
2020-04-18,PASAR MINGGU,46,10,36,39,20,19,43,24,6,9,4
2020-04-18,PASAR REBO,22,8,14,22,15,7,24,8,3,3,10
2020-04-18,PENJARINGAN,54,12,42,41,25,16,41,28,2,4,7
2020-04-18,PESANGGRAHAN,34,2,32,27,22,5,47,16,5,13,13
2020-04-18,PULO GADUNG,96,8,88,57,40,17,62,35,3,7,17
2020-04-18,SAWAH BESAR,93,6,87,51,23,28,18,7,1,3,7
2020-04-18,SENEN,61,16,45,39,26,13,26,15,0,1,10
2020-04-18,SETIA BUDI,43,10,33,33,18,15,36,20,6,5,5
2020-04-18,TAMAN SARI,33,2,31,24,15,9,32,26,0,1,5
2020-04-18,TAMBORA,21,2,19,14,12,2,15,9,2,2,2
2020-04-18,TANAH ABANG,77,17,60,74,47,27,90,25,4,5,56
2020-04-18,TANJUNG PRIOK,101,41,60,76,49,27,55,30,3,6,16
2020-04-18,TEBET,37,3,34,36,23,13,59,38,4,4,13
2020-04-19,BELUM DIKETAHUI,2570,96,2474,2760,241,2519,772,717,6,38,11
2020-04-19,CAKUNG,36,7,29,49,31,18,47,26,4,6,11
2020-04-19,CEMPAKA PUTIH,40,5,35,25,16,9,39,21,4,4,10
2020-04-19,CENGKARENG,38,8,30,18,10,8,42,24,3,5,10
2020-04-19,CILANDAK,58,8,50,53,32,21,58,25,8,12,13
2020-04-19,CILINCING,58,12,46,30,22,8,21,8,0,4,9
2020-04-19,CIPAYUNG,49,11,38,29,23,6,24,15,2,0,7
2020-04-19,CIRACAS,30,5,25,21,14,7,23,10,2,5,6
2020-04-19,DUREN SAWIT,63,8,55,39,34,5,91,52,3,14,22
2020-04-19,GAMBIR,34,5,29,26,21,5,19,7,0,5,7
2020-04-19,GROGOL PETAMBURAN,44,18,26,38,29,9,59,27,12,8,12
2020-04-19,JAGAKARSA,38,4,34,34,21,13,44,25,2,3,14
2020-04-19,JATINEGARA,29,8,21,19,15,4,50,27,0,5,18
2020-04-19,JOHAR BARU,39,4,35,30,19,11,22,9,3,5,5
2020-04-19,KALI DERES,29,5,24,35,27,8,67,25,11,7,24
2020-04-19,KEBAYORAN BARU,49,6,43,46,35,11,44,17,21,3,3
2020-04-19,KEBAYORAN LAMA,54,10,44,36,25,11,58,26,8,12,12
2020-04-19,KEBON JERUK,30,4,26,55,41,14,69,31,11,4,23
2020-04-19,KELAPA GADING,100,46,54,47,40,7,64,24,8,7,25
2020-04-19,KEMAYORAN,65,13,52,70,46,24,46,14,2,7,23
2020-04-19,KEMBANGAN,42,13,29,39,30,9,40,18,10,1,11
2020-04-19,KEP. SERIBU SELATAN,25,0,25,4,0,4,0,0,0,0,0
2020-04-19,KEP. SERIBU UTARA,88,5,83,8,3,5,0,0,0,0,0
2020-04-19,KOJA,58,10,48,32,29,3,26,17,1,0,8
2020-04-19,KRAMAT JATI,35,10,25,32,22,10,49,14,4,5,26
2020-04-19,LUAR DKI JAKARTA,1043,78,965,886,206,680,481,264,27,39,151
2020-04-19,MAKASAR,26,5,21,20,11,9,28,13,2,4,9
2020-04-19,MAMPANG PRAPATAN,52,8,44,22,12,10,21,7,4,4,6
2020-04-19,MATRAMAN,60,10,50,32,23,9,50,22,3,4,21
2020-04-19,MENTENG,30,9,21,23,15,8,26,15,3,6,2
2020-04-19,PADEMANGAN,24,6,18,21,13,8,33,10,0,3,20
2020-04-19,PALMERAH,35,6,29,23,18,5,34,21,2,3,8
2020-04-19,PANCORAN,28,3,25,27,14,13,25,18,2,2,3
2020-04-19,PASAR MINGGU,47,10,37,39,20,19,44,24,6,10,4
2020-04-19,PASAR REBO,22,8,14,22,15,7,25,9,3,3,10
2020-04-19,PENJARINGAN,54,12,42,41,25,16,43,28,2,6,7
2020-04-19,PESANGGRAHAN,35,2,33,28,22,6,40,13,6,12,9
2020-04-19,PULO GADUNG,95,8,87,58,41,17,62,35,3,7,17
2020-04-19,SAWAH BESAR,93,6,87,51,23,28,18,7,1,3,7
2020-04-19,SENEN,61,16,45,39,26,13,27,15,0,1,11
2020-04-19,SETIA BUDI,43,10,33,33,18,15,34,18,6,5,5
2020-04-19,TAMAN SARI,33,2,31,24,15,9,43,38,0,1,4
2020-04-19,TAMBORA,21,2,19,14,12,2,15,10,1,2,2
2020-04-19,TANAH ABANG,78,17,61,75,47,28,92,26,4,5,57
2020-04-19,TANJUNG PRIOK,101,41,60,77,50,27,57,28,3,8,18
2020-04-19,TEBET,38,4,34,37,24,13,61,39,4,4,14
2020-04-20,BELUM DIKETAHUI,2543,94,2449,2761,241,2520,714,640,6,32,36
2020-04-20,CAKUNG,37,7,30,51,31,20,47,26,4,6,11
2020-04-20,CEMPAKA PUTIH,40,5,35,25,16,9,44,22,4,4,14
2020-04-20,CENGKARENG,38,8,30,18,10,8,43,24,3,6,10
2020-04-20,CILANDAK,58,8,50,53,32,21,58,23,10,12,13
2020-04-20,CILINCING,62,12,50,33,23,10,21,8,0,4,9
2020-04-20,CIPAYUNG,55,11,44,30,23,7,26,16,3,0,7
2020-04-20,CIRACAS,31,6,25,21,14,7,24,10,2,5,7
2020-04-20,DUREN SAWIT,66,8,58,39,34,5,95,54,3,16,22
2020-04-20,GAMBIR,34,5,29,26,21,5,23,9,1,6,7
2020-04-20,GROGOL PETAMBURAN,45,18,27,38,29,9,63,29,14,8,12
2020-04-20,JAGAKARSA,40,4,36,34,21,13,46,27,2,3,14
2020-04-20,JATINEGARA,32,8,24,19,15,4,53,30,0,5,18
2020-04-20,JOHAR BARU,40,4,36,30,19,11,25,10,5,5,5
2020-04-20,KALI DERES,30,5,25,35,27,8,71,26,13,7,25
2020-04-20,KEBAYORAN BARU,49,6,43,46,35,11,44,16,22,3,3
2020-04-20,KEBAYORAN LAMA,54,10,44,36,25,11,61,27,8,12,14
2020-04-20,KEBON JERUK,32,4,28,55,41,14,73,32,11,4,26
2020-04-20,KELAPA GADING,101,46,55,49,40,9,66,21,10,7,28
2020-04-20,KEMAYORAN,65,13,52,70,46,24,49,14,3,8,24
2020-04-20,KEMBANGAN,42,13,29,39,30,9,43,19,11,2,11
2020-04-20,KEP. SERIBU SELATAN,25,0,25,4,0,4,0,0,0,0,0
2020-04-20,KEP. SERIBU UTARA,88,5,83,10,3,7,0,0,0,0,0
2020-04-20,KOJA,63,10,53,32,29,3,30,18,1,1,10
2020-04-20,KRAMAT JATI,36,10,26,32,22,10,52,16,4,5,27
2020-04-20,LUAR DKI JAKARTA,1046,78,968,891,207,684,503,276,33,40,154
2020-04-20,MAKASAR,26,5,21,20,11,9,28,12,4,4,8
2020-04-20,MAMPANG PRAPATAN,52,8,44,22,12,10,21,7,4,4,6
2020-04-20,MATRAMAN,62,11,51,34,24,10,51,22,3,4,22
2020-04-20,MENTENG,30,9,21,23,15,8,27,16,3,6,2
2020-04-20,PADEMANGAN,24,6,18,22,13,9,37,14,0,3,20
2020-04-20,PALMERAH,37,6,31,23,18,5,34,21,2,3,8
2020-04-20,PANCORAN,29,3,26,27,14,13,26,18,2,2,4
2020-04-20,PASAR MINGGU,49,10,39,39,20,19,49,26,6,10,7
2020-04-20,PASAR REBO,22,8,14,22,15,7,25,9,3,3,10
2020-04-20,PENJARINGAN,54,12,42,42,25,17,43,28,2,6,7
2020-04-20,PESANGGRAHAN,35,2,33,28,22,6,41,14,6,12,9
2020-04-20,PULO GADUNG,96,8,88,59,41,18,65,36,5,7,17
2020-04-20,SAWAH BESAR,93,6,87,51,23,28,24,11,2,4,7
2020-04-20,SENEN,61,16,45,39,26,13,32,18,1,1,12
2020-04-20,SETIA BUDI,43,10,33,34,18,16,34,17,7,5,5
2020-04-20,TAMAN SARI,41,2,39,25,15,10,45,39,0,2,4
2020-04-20,TAMBORA,22,2,20,14,12,2,16,11,1,2,2
2020-04-20,TANAH ABANG,79,17,62,74,47,27,97,28,6,5,58
2020-04-20,TANJUNG PRIOK,105,41,64,78,50,28,78,45,3,9,21
2020-04-20,TEBET,38,4,34,38,25,13,65,41,4,4,16
2020-04-21,BELUM DIKETAHUI,2590,94,2496,2760,241,2519,774,692,12,27,43
2020-04-21,CAKUNG,36,7,29,51,31,20,50,28,5,6,11
2020-04-21,CEMPAKA PUTIH,40,5,35,25,16,9,45,23,4,5,13
2020-04-21,CENGKARENG,38,8,30,18,10,8,45,24,5,6,10
2020-04-21,CILANDAK,58,8,50,54,33,21,62,24,11,12,15
2020-04-21,CILINCING,59,12,47,33,23,10,21,8,0,4,9
2020-04-21,CIPAYUNG,56,11,45,30,23,7,26,16,4,0,6
2020-04-21,CIRACAS,31,6,25,22,15,7,27,13,2,5,7
2020-04-21,DUREN SAWIT,65,8,57,40,34,6,100,57,4,17,22
2020-04-21,GAMBIR,34,5,29,26,21,5,24,10,1,6,7
2020-04-21,GROGOL PETAMBURAN,45,18,27,38,29,9,62,24,18,8,12
2020-04-21,JAGAKARSA,39,4,35,34,21,13,48,28,2,3,15
2020-04-21,JATINEGARA,32,8,24,19,15,4,56,32,0,5,19
2020-04-21,JOHAR BARU,39,4,35,30,19,11,26,10,6,5,5
2020-04-21,KALI DERES,30,5,25,35,27,8,75,25,17,7,26
2020-04-21,KEBAYORAN BARU,49,6,43,46,35,11,45,16,23,3,3
2020-04-21,KEBAYORAN LAMA,54,10,44,37,26,11,63,27,9,13,14
2020-04-21,KEBON JERUK,32,4,28,55,41,14,77,36,11,4,26
2020-04-21,KELAPA GADING,101,46,55,49,40,9,66,20,11,7,28
2020-04-21,KEMAYORAN,65,13,52,70,46,24,50,15,4,8,23
2020-04-21,KEMBANGAN,42,13,29,39,30,9,43,19,11,2,11
2020-04-21,KEP. SERIBU SELATAN,25,0,25,4,0,4,0,0,0,0,0
2020-04-21,KEP. SERIBU UTARA,88,5,83,10,3,7,0,0,0,0,0
2020-04-21,KOJA,62,10,52,32,29,3,32,18,3,1,10
2020-04-21,KRAMAT JATI,36,10,26,32,22,10,57,19,4,5,29
2020-04-21,LUAR DKI JAKARTA,1054,78,976,893,208,685,520,292,43,41,144
2020-04-21,MAKASAR,26,5,21,20,11,9,31,15,4,4,8
2020-04-21,MAMPANG PRAPATAN,52,8,44,22,12,10,23,8,4,5,6
2020-04-21,MATRAMAN,62,11,51,34,24,10,56,27,3,5,21
2020-04-21,MENTENG,30,9,21,23,15,8,29,17,3,7,2
2020-04-21,PADEMANGAN,24,6,18,21,13,8,37,12,2,3,20
2020-04-21,PALMERAH,38,6,32,23,18,5,35,22,2,3,8
2020-04-21,PANCORAN,29,3,26,27,14,13,27,17,3,3,4
2020-04-21,PASAR MINGGU,49,10,39,40,21,19,56,28,9,12,7
2020-04-21,PASAR REBO,23,9,14,22,15,7,25,9,3,3,10
2020-04-21,PENJARINGAN,54,12,42,42,25,17,44,28,3,6,7
2020-04-21,PESANGGRAHAN,35,2,33,29,22,7,42,15,6,12,9
2020-04-21,PULO GADUNG,96,8,88,60,41,19,70,38,6,9,17
2020-04-21,SAWAH BESAR,93,6,87,51,23,28,23,11,2,4,6
2020-04-21,SENEN,61,16,45,39,26,13,35,19,2,1,13
2020-04-21,SETIA BUDI,43,10,33,34,18,16,38,21,7,5,5
2020-04-21,TAMAN SARI,41,2,39,26,15,11,45,39,0,2,4
2020-04-21,TAMBORA,22,2,20,14,12,2,18,13,1,2,2
2020-04-21,TANAH ABANG,80,17,63,74,47,27,98,28,6,5,59
2020-04-21,TANJUNG PRIOK,103,41,62,78,50,28,82,48,4,9,21
2020-04-21,TEBET,38,4,34,40,26,14,71,44,6,5,16
2020-04-22,BELUM DIKETAHUI,2598,94,2504,2761,242,2519,729,656,12,28,33
2020-04-22,CAKUNG,36,7,29,51,31,20,53,30,5,6,12
2020-04-22,CEMPAKA PUTIH,40,5,35,25,16,9,46,22,4,5,15
2020-04-22,CENGKARENG,39,8,31,18,10,8,50,27,6,6,11
2020-04-22,CILANDAK,59,8,51,54,33,21,65,27,11,12,15
2020-04-22,CILINCING,60,12,48,35,25,10,26,12,0,4,10
2020-04-22,CIPAYUNG,56,11,45,30,23,7,27,17,4,0,6
2020-04-22,CIRACAS,32,6,26,22,15,7,28,14,2,5,7
2020-04-22,DUREN SAWIT,65,8,57,40,34,6,112,58,4,17,33
2020-04-22,GAMBIR,34,5,29,26,21,5,25,11,1,6,7
2020-04-22,GROGOL PETAMBURAN,45,18,27,38,29,9,67,27,19,8,13
2020-04-22,JAGAKARSA,39,4,35,34,21,13,52,29,2,3,18
2020-04-22,JATINEGARA,32,8,24,19,15,4,58,33,0,6,19
2020-04-22,JOHAR BARU,40,4,36,30,19,11,26,11,5,5,5
2020-04-22,KALI DERES,30,5,25,35,27,8,80,30,17,7,26
2020-04-22,KEBAYORAN BARU,50,6,44,46,35,11,47,16,23,3,5
2020-04-22,KEBAYORAN LAMA,54,10,44,37,26,11,67,28,10,13,16
2020-04-22,KEBON JERUK,32,4,28,55,41,14,83,42,11,4,26
2020-04-22,KELAPA GADING,101,46,55,50,40,10,72,26,12,6,28
2020-04-22,KEMAYORAN,65,13,52,71,47,24,51,16,4,8,23
2020-04-22,KEMBANGAN,42,13,29,39,30,9,48,20,11,2,15
2020-04-22,KEP. SERIBU SELATAN,25,0,25,4,0,4,2,0,0,0,2
2020-04-22,KEP. SERIBU UTARA,88,5,83,10,3,7,0,0,0,0,0
2020-04-22,KOJA,64,10,54,34,31,3,37,19,3,1,14
2020-04-22,KRAMAT JATI,37,10,27,33,23,10,57,19,4,5,29
2020-04-22,LUAR DKI JAKARTA,1055,78,977,894,209,685,531,296,44,41,150
2020-04-22,MAKASAR,26,5,21,20,11,9,33,17,4,4,8
2020-04-22,MAMPANG PRAPATAN,52,8,44,22,12,10,25,9,4,5,7
2020-04-22,MATRAMAN,64,11,53,35,25,10,60,28,3,4,25
2020-04-22,MENTENG,30,9,21,23,15,8,29,17,3,7,2
2020-04-22,PADEMANGAN,24,6,18,21,13,8,43,18,2,3,20
2020-04-22,PALMERAH,38,6,32,23,18,5,40,26,3,3,8
2020-04-22,PANCORAN,29,3,26,27,14,13,30,20,3,3,4
2020-04-22,PASAR MINGGU,49,10,39,40,21,19,58,29,9,13,7
2020-04-22,PASAR REBO,23,9,14,22,15,7,25,9,3,3,10
2020-04-22,PENJARINGAN,54,12,42,42,25,17,49,31,3,6,9
2020-04-22,PESANGGRAHAN,35,2,33,29,22,7,46,19,6,12,9
2020-04-22,PULO GADUNG,96,8,88,60,41,19,72,39,6,9,18
2020-04-22,SAWAH BESAR,96,6,90,51,23,28,24,12,2,4,6
2020-04-22,SENEN,61,16,45,39,26,13,36,19,2,2,13
2020-04-22,SETIA BUDI,43,10,33,34,18,16,39,22,7,5,5
2020-04-22,TAMAN SARI,41,2,39,26,15,11,47,41,0,2,4
2020-04-22,TAMBORA,23,2,21,14,12,2,21,16,1,2,2
2020-04-22,TANAH ABANG,80,17,63,75,48,27,118,30,6,5,77
2020-04-22,TANJUNG PRIOK,104,41,63,78,50,28,93,53,4,9,27
2020-04-22,TEBET,38,4,34,40,26,14,72,44,6,6,16
2020-04-23,BELUM DIKETAHUI,2537,91,2446,2758,241,2517,711,620,13,26,52
2020-04-23,CAKUNG,37,7,30,50,30,20,59,31,5,6,17
2020-04-23,CEMPAKA PUTIH,40,5,35,25,16,9,52,25,4,6,17
2020-04-23,CENGKARENG,38,8,30,18,10,8,52,28,6,6,12
2020-04-23,CILANDAK,59,8,51,54,33,21,66,28,11,12,15
2020-04-23,CILINCING,59,12,47,35,25,10,31,16,0,4,11
2020-04-23,CIPAYUNG,56,11,45,33,25,8,28,17,4,0,7
2020-04-23,CIRACAS,32,6,26,22,15,7,27,12,2,5,8
2020-04-23,DUREN SAWIT,65,8,57,40,34,6,117,63,4,17,33
2020-04-23,GAMBIR,33,5,28,25,20,5,29,10,2,6,11
2020-04-23,GROGOL PETAMBURAN,45,18,27,38,29,9,67,26,18,9,14
2020-04-23,JAGAKARSA,39,4,35,34,21,13,54,29,2,4,19
2020-04-23,JATINEGARA,32,8,24,19,15,4,61,32,0,7,22
2020-04-23,JOHAR BARU,44,4,40,30,19,11,26,11,5,5,5
2020-04-23,KALI DERES,30,5,25,35,27,8,83,33,17,7,26
2020-04-23,KEBAYORAN BARU,50,6,44,46,35,11,47,16,23,3,5
2020-04-23,KEBAYORAN LAMA,54,10,44,35,25,10,68,29,10,13,16
2020-04-23,KEBON JERUK,32,3,29,54,40,14,85,43,11,4,27
2020-04-23,KELAPA GADING,102,46,56,51,40,11,74,28,12,6,28
2020-04-23,KEMAYORAN,65,13,52,71,47,24,54,18,5,8,23
2020-04-23,KEMBANGAN,41,13,28,39,30,9,52,24,11,2,15
2020-04-23,KEP. SERIBU SELATAN,25,0,25,4,0,4,2,0,0,0,2
2020-04-23,KEP. SERIBU UTARA,88,5,83,10,3,7,0,0,0,0,0
2020-04-23,KOJA,61,10,51,34,31,3,37,19,3,1,14
2020-04-23,KRAMAT JATI,38,10,28,33,23,10,59,18,4,6,31
2020-04-23,LUAR DKI JAKARTA,1137,82,1055,904,216,688,547,309,43,41,154
2020-04-23,MAKASAR,26,5,21,20,11,9,34,18,4,4,8
2020-04-23,MAMPANG PRAPATAN,52,8,44,22,12,10,30,11,4,5,10
2020-04-23,MATRAMAN,64,11,53,36,25,11,62,29,3,5,25
2020-04-23,MENTENG,39,9,30,24,15,9,36,20,3,7,6
2020-04-23,PADEMANGAN,24,6,18,21,13,8,46,17,2,3,24
2020-04-23,PALMERAH,38,6,32,23,18,5,41,25,3,4,9
2020-04-23,PANCORAN,29,3,26,26,13,13,31,21,3,3,4
2020-04-23,PASAR MINGGU,52,10,42,40,21,19,61,31,9,13,8
2020-04-23,PASAR REBO,23,9,14,22,15,7,25,9,3,3,10
2020-04-23,PENJARINGAN,54,12,42,50,25,25,49,31,3,6,9
2020-04-23,PESANGGRAHAN,34,2,32,28,22,6,50,21,6,13,10
2020-04-23,PULO GADUNG,98,8,90,60,41,19,78,43,6,8,21
2020-04-23,SAWAH BESAR,96,6,90,51,23,28,26,13,2,4,7
2020-04-23,SENEN,62,16,46,39,26,13,39,22,2,2,13
2020-04-23,SETIA BUDI,44,10,34,34,18,16,41,23,7,6,5
2020-04-23,TAMAN SARI,41,2,39,26,15,11,51,41,0,3,7
2020-04-23,TAMBORA,23,2,21,14,12,2,21,16,1,2,2
2020-04-23,TANAH ABANG,80,17,63,74,47,27,126,32,6,5,83
2020-04-23,TANJUNG PRIOK,104,41,63,79,50,29,95,55,4,9,27
2020-04-23,TEBET,40,4,36,41,27,14,76,47,6,7,16
2020-04-24,BELUM DIKETAHUI,2599,47,2552,2756,144,2612,635,534,13,24,64
2020-04-24,CAKUNG,38,2,36,53,20,33,60,31,6,6,17
2020-04-24,CEMPAKA PUTIH,40,1,39,25,11,14,63,28,4,6,25
2020-04-24,CENGKARENG,39,2,37,18,4,14,56,32,6,6,12
2020-04-24,CILANDAK,59,3,56,55,8,47,68,29,11,13,15
2020-04-24,CILINCING,63,2,61,35,16,19,31,16,0,4,11
2020-04-24,CIPAYUNG,57,2,55,34,16,18,31,17,4,0,10
2020-04-24,CIRACAS,33,2,31,25,7,18,28,13,2,5,8
2020-04-24,DUREN SAWIT,67,0,67,40,25,15,119,63,6,18,32
2020-04-24,GAMBIR,34,4,30,27,14,13,30,11,2,6,11
2020-04-24,GROGOL PETAMBURAN,46,1,45,38,12,26,77,34,20,9,14
2020-04-24,JAGAKARSA,40,0,40,35,7,28,54,28,3,4,19
2020-04-24,JATINEGARA,32,3,29,20,9,11,67,36,0,7,24
2020-04-24,JOHAR BARU,45,0,45,30,14,16,27,11,5,6,5
2020-04-24,KALI DERES,30,1,29,35,9,26,85,34,19,7,25
2020-04-24,KEBAYORAN BARU,50,4,46,47,25,22,49,17,24,3,5
2020-04-24,KEBAYORAN LAMA,55,1,54,38,17,21,69,29,11,13,16
2020-04-24,KEBON JERUK,33,2,31,55,18,37,90,42,17,5,26
2020-04-24,KELAPA GADING,103,1,102,51,18,33,75,29,12,6,28
2020-04-24,KEMAYORAN,65,6,59,71,34,37,60,20,5,9,26
2020-04-24,KEMBANGAN,42,3,39,39,17,22,53,22,15,2,14
2020-04-24,KEP. SERIBU SELATAN,25,0,25,4,0,4,2,0,0,0,2
2020-04-24,KEP. SERIBU UTARA,88,0,88,10,1,9,0,0,0,0,0
2020-04-24,KOJA,65,8,57,35,16,19,37,17,4,2,14
2020-04-24,KRAMAT JATI,38,2,36,33,15,18,63,21,4,6,32
2020-04-24,LUAR DKI JAKARTA,1065,21,1044,899,111,788,582,332,46,44,160
2020-04-24,MAKASAR,26,2,24,20,4,16,35,15,8,4,8
2020-04-24,MAMPANG PRAPATAN,52,1,51,22,10,12,30,10,5,5,10
2020-04-24,MATRAMAN,65,5,60,37,18,19,64,29,3,6,26
2020-04-24,MENTENG,40,0,40,23,10,13,41,25,3,7,6
2020-04-24,PADEMANGAN,24,2,22,21,9,12,54,21,2,4,27
2020-04-24,PALMERAH,39,3,36,23,14,9,55,26,6,4,19
2020-04-24,PANCORAN,29,1,28,26,8,18,33,22,3,3,5
2020-04-24,PASAR MINGGU,53,5,48,42,13,29,63,32,10,13,8
2020-04-24,PASAR REBO,23,6,17,23,8,15,27,10,3,3,11
2020-04-24,PENJARINGAN,55,3,52,50,9,41,51,33,3,6,9
2020-04-24,PESANGGRAHAN,35,1,34,29,8,21,50,20,7,13,10
2020-04-24,PULO GADUNG,98,6,92,61,27,34,80,42,7,9,22
2020-04-24,SAWAH BESAR,96,4,92,51,16,35,27,14,2,4,7
2020-04-24,SENEN,64,1,63,39,18,21,41,23,2,2,14
2020-04-24,SETIA BUDI,44,1,43,34,5,29,42,24,7,6,5
2020-04-24,TAMAN SARI,41,1,40,26,10,16,51,40,0,4,7
2020-04-24,TAMBORA,23,1,22,14,9,5,21,16,1,2,2
2020-04-24,TANAH ABANG,82,6,76,76,35,41,152,36,6,8,102
2020-04-24,TANJUNG PRIOK,105,4,101,81,28,53,99,55,4,10,30
2020-04-24,TEBET,39,1,38,42,13,29,78,49,6,7,16
2020-04-25,BELUM DIKETAHUI,2604,48,2556,2754,144,2610,559,436,14,19,90
2020-04-25,CAKUNG,38,2,36,54,21,33,64,33,6,7,18
2020-04-25,CEMPAKA PUTIH,40,1,39,25,11,14,65,28,5,6,26
2020-04-25,CENGKARENG,39,2,37,18,4,14,59,35,6,6,12
2020-04-25,CILANDAK,61,3,58,56,9,47,71,31,12,13,15
2020-04-25,CILINCING,65,3,62,36,16,20,33,18,0,4,11
2020-04-25,CIPAYUNG,61,3,58,34,16,18,33,19,4,0,10
2020-04-25,CIRACAS,39,3,36,26,8,18,30,15,2,5,8
2020-04-25,DUREN SAWIT,67,0,67,40,25,15,120,63,6,19,32
2020-04-25,GAMBIR,34,4,30,27,14,13,31,12,2,6,11
2020-04-25,GROGOL PETAMBURAN,46,1,45,38,12,26,79,34,21,9,15
2020-04-25,JAGAKARSA,41,0,41,37,7,30,55,29,3,4,19
2020-04-25,JATINEGARA,33,4,29,20,9,11,66,35,0,7,24
2020-04-25,JOHAR BARU,45,0,45,30,14,16,32,14,5,6,7
2020-04-25,KALI DERES,31,1,30,36,10,26,87,34,19,8,26
2020-04-25,KEBAYORAN BARU,51,4,47,48,26,22,51,18,24,3,6
2020-04-25,KEBAYORAN LAMA,57,2,55,38,17,21,75,31,11,13,20
2020-04-25,KEBON JERUK,33,2,31,55,18,37,97,43,17,7,30
2020-04-25,KELAPA GADING,104,1,103,51,18,33,75,29,12,6,28
2020-04-25,KEMAYORAN,65,6,59,72,35,37,62,21,5,10,26
2020-04-25,KEMBANGAN,42,3,39,39,17,22,55,23,15,3,14
2020-04-25,KEP. SERIBU SELATAN,25,0,25,4,0,4,3,0,0,0,3
2020-04-25,KEP. SERIBU UTARA,88,0,88,10,1,9,0,0,0,0,0
2020-04-25,KOJA,67,8,59,35,16,19,40,19,4,2,15
2020-04-25,KRAMAT JATI,38,2,36,33,15,18,65,21,4,7,33
2020-04-25,LUAR DKI JAKARTA,1087,22,1065,900,112,788,615,349,46,49,171
2020-04-25,MAKASAR,26,2,24,20,4,16,40,19,8,5,8
2020-04-25,MAMPANG PRAPATAN,54,1,53,22,10,12,30,10,5,5,10
2020-04-25,MATRAMAN,69,6,63,40,18,22,69,33,3,6,27
2020-04-25,MENTENG,40,0,40,23,10,13,46,24,3,8,11
2020-04-25,PADEMANGAN,24,2,22,22,9,13,60,20,2,4,34
2020-04-25,PALMERAH,39,3,36,23,14,9,56,24,6,5,21
2020-04-25,PANCORAN,29,1,28,26,8,18,36,24,3,4,5
2020-04-25,PASAR MINGGU,59,5,54,46,14,32,64,32,10,13,9
2020-04-25,PASAR REBO,23,6,17,24,9,15,27,10,3,3,11
2020-04-25,PENJARINGAN,57,3,54,50,9,41,55,37,3,6,9
2020-04-25,PESANGGRAHAN,35,1,34,29,8,21,52,20,7,13,12
2020-04-25,PULO GADUNG,99,6,93,63,27,36,84,45,7,9,23
2020-04-25,SAWAH BESAR,96,4,92,51,16,35,28,14,2,5,7
2020-04-25,SENEN,64,1,63,39,18,21,42,22,2,3,15
2020-04-25,SETIA BUDI,45,1,44,35,6,29,42,24,7,6,5
2020-04-25,TAMAN SARI,41,1,40,28,11,17,52,41,0,4,7
2020-04-25,TAMBORA,23,1,22,15,9,6,23,16,1,3,3
2020-04-25,TANAH ABANG,86,6,80,77,35,42,162,38,6,10,108
2020-04-25,TANJUNG PRIOK,108,4,104,81,28,53,107,57,5,12,33
2020-04-25,TEBET,42,1,41,42,13,29,84,47,8,7,22
2020-04-26,BELUM DIKETAHUI,2605,48,2557,2755,145,2610,482,371,16,19,76
2020-04-26,CAKUNG,39,2,37,55,22,33,67,34,6,7,20
2020-04-26,CEMPAKA PUTIH,40,1,39,25,11,14,66,28,5,6,27
2020-04-26,CENGKARENG,39,2,37,18,4,14,63,39,6,6,12
2020-04-26,CILANDAK,61,3,58,56,9,47,72,31,12,14,15
2020-04-26,CILINCING,65,3,62,37,17,20,37,21,0,4,12
2020-04-26,CIPAYUNG,62,4,58,36,18,18,31,16,4,0,11
2020-04-26,CIRACAS,40,3,37,28,10,18,34,17,2,5,10
2020-04-26,DUREN SAWIT,71,1,70,40,25,15,125,67,6,20,32
2020-04-26,GAMBIR,34,4,30,27,14,13,31,12,2,6,11
2020-04-26,GROGOL PETAMBURAN,47,1,46,38,12,26,80,35,22,9,14
2020-04-26,JAGAKARSA,42,0,42,38,8,30,57,30,3,4,20
2020-04-26,JATINEGARA,34,4,30,20,9,11,68,37,0,7,24
2020-04-26,JOHAR BARU,46,1,45,30,14,16,32,14,5,6,7
2020-04-26,KALI DERES,31,1,30,36,10,26,88,35,19,8,26
2020-04-26,KEBAYORAN BARU,53,4,49,51,29,22,52,19,24,3,6
2020-04-26,KEBAYORAN LAMA,58,2,56,38,17,21,77,33,11,13,20
2020-04-26,KEBON JERUK,33,2,31,55,18,37,100,43,17,8,32
2020-04-26,KELAPA GADING,104,1,103,51,18,33,79,32,12,6,29
2020-04-26,KEMAYORAN,66,7,59,72,35,37,62,18,5,11,28
2020-04-26,KEMBANGAN,42,3,39,39,17,22,56,24,15,3,14
2020-04-26,KEP. SERIBU SELATAN,25,0,25,4,0,4,9,6,0,0,3
2020-04-26,KEP. SERIBU UTARA,88,0,88,10,1,9,1,0,0,0,1
2020-04-26,KOJA,67,8,59,35,16,19,41,21,3,2,15
2020-04-26,KRAMAT JATI,38,2,36,33,15,18,66,22,4,7,33
2020-04-26,LUAR DKI JAKARTA,1090,22,1068,900,113,787,659,368,46,52,193
2020-04-26,MAKASAR,27,2,25,20,4,16,43,21,8,5,9
2020-04-26,MAMPANG PRAPATAN,54,1,53,22,10,12,30,10,5,5,10
2020-04-26,MATRAMAN,69,6,63,40,18,22,70,34,3,6,27
2020-04-26,MENTENG,42,0,42,23,10,13,47,24,3,8,12
2020-04-26,PADEMANGAN,24,2,22,22,9,13,63,22,2,4,35
2020-04-26,PALMERAH,39,3,36,23,14,9,57,25,6,5,21
2020-04-26,PANCORAN,29,1,28,26,8,18,38,24,3,4,7
2020-04-26,PASAR MINGGU,60,5,55,46,14,32,67,33,10,12,12
2020-04-26,PASAR REBO,23,6,17,24,9,15,30,11,3,3,13
2020-04-26,PENJARINGAN,57,3,54,50,9,41,57,38,4,5,10
2020-04-26,PESANGGRAHAN,35,1,34,29,8,21,53,21,7,13,12
2020-04-26,PULO GADUNG,101,6,95,64,28,36,86,44,7,9,26
2020-04-26,SAWAH BESAR,96,4,92,51,16,35,34,19,2,5,8
2020-04-26,SENEN,65,2,63,39,18,21,43,22,3,3,15
2020-04-26,SETIA BUDI,45,1,44,35,6,29,43,25,7,6,5
2020-04-26,TAMAN SARI,41,1,40,29,12,17,53,42,0,4,7
2020-04-26,TAMBORA,23,1,22,15,9,6,26,18,1,3,4
2020-04-26,TANAH ABANG,89,6,83,77,35,42,175,39,6,10,120
2020-04-26,TANJUNG PRIOK,109,5,104,81,28,53,112,61,5,13,33
2020-04-26,TEBET,42,1,41,42,13,29,84,46,8,8,22
2020-04-27,BELUM DIKETAHUI,2639,48,2591,2759,149,2610,459,343,15,19,82
2020-04-27,CAKUNG,40,2,38,57,24,33,71,35,6,9,21
2020-04-27,CEMPAKA PUTIH,41,1,40,25,11,14,68,30,5,6,27
2020-04-27,CENGKARENG,39,2,37,18,4,14,67,38,7,7,15
2020-04-27,CILANDAK,64,3,61,57,10,47,72,31,12,14,15
2020-04-27,CILINCING,67,3,64,38,18,20,38,20,0,4,14
2020-04-27,CIPAYUNG,65,4,61,37,19,18,37,22,4,1,10
2020-04-27,CIRACAS,41,3,38,28,10,18,35,17,2,5,11
2020-04-27,DUREN SAWIT,72,1,71,40,25,15,126,67,6,21,32
2020-04-27,GAMBIR,35,4,31,27,14,13,31,12,2,6,11
2020-04-27,GROGOL PETAMBURAN,48,1,47,38,12,26,81,32,23,10,16
2020-04-27,JAGAKARSA,42,0,42,38,8,30,60,29,3,4,24
2020-04-27,JATINEGARA,34,4,30,20,9,11,70,38,0,8,24
2020-04-27,JOHAR BARU,46,1,45,30,14,16,32,11,5,6,10
2020-04-27,KALI DERES,31,1,30,37,11,26,90,35,19,9,27
2020-04-27,KEBAYORAN BARU,55,4,51,52,30,22,54,21,24,3,6
2020-04-27,KEBAYORAN LAMA,61,2,59,39,18,21,79,34,11,14,20
2020-04-27,KEBON JERUK,33,2,31,55,18,37,101,42,17,9,33
2020-04-27,KELAPA GADING,104,1,103,51,18,33,80,31,12,6,31
2020-04-27,KEMAYORAN,67,8,59,72,35,37,62,18,5,11,28
2020-04-27,KEMBANGAN,44,3,41,39,17,22,64,25,15,4,20
2020-04-27,KEP. SERIBU SELATAN,25,0,25,4,0,4,9,6,0,0,3
2020-04-27,KEP. SERIBU UTARA,88,0,88,10,1,9,1,0,0,0,1
2020-04-27,KOJA,68,8,60,35,16,19,43,22,3,2,16
2020-04-27,KRAMAT JATI,38,2,36,33,15,18,68,23,4,7,34
2020-04-27,LUAR DKI JAKARTA,1120,22,1098,902,115,787,678,381,46,52,199
2020-04-27,MAKASAR,27,2,25,21,5,16,44,21,8,6,9
2020-04-27,MAMPANG PRAPATAN,56,1,55,22,10,12,31,10,5,5,11
2020-04-27,MATRAMAN,70,6,64,40,18,22,72,35,3,7,27
2020-04-27,MENTENG,42,0,42,23,10,13,47,23,3,8,13
2020-04-27,PADEMANGAN,24,2,22,23,9,14,64,20,2,4,38
2020-04-27,PALMERAH,39,3,36,24,15,9,59,27,6,5,21
2020-04-27,PANCORAN,29,1,28,26,8,18,37,23,3,4,7
2020-04-27,PASAR MINGGU,63,5,58,47,15,32,70,34,9,12,15
2020-04-27,PASAR REBO,24,6,18,24,9,15,31,11,3,3,14
2020-04-27,PENJARINGAN,57,3,54,50,9,41,58,38,3,6,11
2020-04-27,PESANGGRAHAN,35,1,34,29,8,21,57,22,7,14,14
2020-04-27,PULO GADUNG,101,6,95,64,28,36,87,45,7,9,26
2020-04-27,SAWAH BESAR,96,4,92,51,16,35,37,21,2,5,9
2020-04-27,SENEN,65,2,63,39,18,21,49,22,3,3,21
2020-04-27,SETIA BUDI,45,1,44,35,6,29,43,25,7,6,5
2020-04-27,TAMAN SARI,41,1,40,29,12,17,53,42,0,4,7
2020-04-27,TAMBORA,23,1,22,15,9,6,26,18,1,3,4
2020-04-27,TANAH ABANG,90,6,84,77,35,42,182,39,6,10,127
2020-04-27,TANJUNG PRIOK,109,5,104,81,28,53,121,68,5,13,35
2020-04-27,TEBET,42,1,41,43,14,29,88,43,9,11,25
2020-04-28,BELUM DIKETAHUI,2641,49,2592,2751,148,2603,449,350,15,13,71
2020-04-28,CAKUNG,101,2,99,62,26,36,75,39,6,9,21
2020-04-28,CEMPAKA PUTIH,134,1,133,58,12,46,70,31,5,6,28
2020-04-28,CENGKARENG,52,2,50,30,7,23,68,39,7,7,15
2020-04-28,CILANDAK,79,4,75,58,10,48,72,31,12,14,15
2020-04-28,CILINCING,134,4,130,39,18,21,39,21,0,4,14
2020-04-28,CIPAYUNG,69,4,65,38,19,19,37,22,4,1,10
2020-04-28,CIRACAS,86,3,83,35,11,24,36,17,2,5,12
2020-04-28,DUREN SAWIT,87,1,86,44,26,18,129,68,6,22,33
2020-04-28,GAMBIR,70,5,65,29,16,13,30,12,2,6,10
2020-04-28,GROGOL PETAMBURAN,66,2,64,39,13,26,87,35,24,10,18
2020-04-28,JAGAKARSA,49,0,49,42,8,34,61,29,4,4,24
2020-04-28,JATINEGARA,39,4,35,21,9,12,71,37,0,9,25
2020-04-28,JOHAR BARU,72,1,71,33,14,19,33,11,5,6,11
2020-04-28,KALI DERES,59,2,57,41,11,30,90,35,19,9,27
2020-04-28,KEBAYORAN BARU,57,4,53,52,30,22,54,21,24,3,6
2020-04-28,KEBAYORAN LAMA,64,2,62,39,18,21,80,34,11,15,20
2020-04-28,KEBON JERUK,55,2,53,59,18,41,104,45,17,9,33
2020-04-28,KELAPA GADING,160,1,159,66,19,47,84,32,12,7,33
2020-04-28,KEMAYORAN,155,8,147,74,36,38,65,19,5,12,29
2020-04-28,KEMBANGAN,47,3,44,39,17,22,67,27,15,4,21
2020-04-28,KEP. SERIBU SELATAN,32,0,32,4,0,4,9,0,0,0,9
2020-04-28,KEP. SERIBU UTARA,102,2,100,12,1,11,1,0,0,0,1
2020-04-28,KOJA,122,8,114,55,19,36,52,28,3,2,19
2020-04-28,KRAMAT JATI,40,2,38,33,15,18,68,23,4,7,34
2020-04-28,LUAR DKI JAKARTA,1211,23,1188,905,115,790,705,400,46,52,207
2020-04-28,MAKASAR,30,2,28,22,5,17,45,21,8,6,10
2020-04-28,MAMPANG PRAPATAN,73,1,72,23,10,13,32,10,5,5,12
2020-04-28,MATRAMAN,102,7,95,59,22,37,74,36,3,7,28
2020-04-28,MENTENG,53,0,53,23,10,13,49,25,3,8,13
2020-04-28,PADEMANGAN,78,2,76,28,9,19,69,20,2,6,41
2020-04-28,PALMERAH,51,3,48,34,16,18,63,30,6,5,22
2020-04-28,PANCORAN,36,1,35,27,8,19,38,25,3,3,7
2020-04-28,PASAR MINGGU,113,7,106,52,17,35,73,35,9,12,17
2020-04-28,PASAR REBO,26,6,20,24,9,15,30,10,3,4,13
2020-04-28,PENJARINGAN,98,3,95,52,9,43,65,42,3,6,14
2020-04-28,PESANGGRAHAN,40,1,39,30,9,21,59,23,7,14,15
2020-04-28,PULO GADUNG,111,6,105,68,28,40,87,45,7,9,26
2020-04-28,SAWAH BESAR,108,6,102,52,17,35,47,30,2,5,10
2020-04-28,SENEN,72,2,70,40,18,22,51,23,3,3,22
2020-04-28,SETIA BUDI,60,1,59,36,7,29,43,25,7,6,5
2020-04-28,TAMAN SARI,53,1,52,30,12,18,55,44,0,4,7
2020-04-28,TAMBORA,35,2,33,21,12,9,24,14,2,3,5
2020-04-28,TANAH ABANG,119,6,113,77,35,42,193,48,6,11,128
2020-04-28,TANJUNG PRIOK,144,10,134,99,42,57,130,70,5,15,40
2020-04-28,TEBET,48,1,47,44,14,30,87,42,9,11,25
2020-04-29,BELUM DIKETAHUI,2641,49,2592,2752,149,2603,401,314,16,10,61
2020-04-29,CAKUNG,159,4,155,64,27,37,78,35,10,9,24
2020-04-29,CEMPAKA PUTIH,162,1,161,59,12,47,72,32,5,7,28
2020-04-29,CENGKARENG,57,2,55,30,7,23,68,39,7,7,15
2020-04-29,CILANDAK,87,5,82,59,10,49,74,31,12,14,17
2020-04-29,CILINCING,195,4,191,42,20,22,41,22,0,4,15
2020-04-29,CIPAYUNG,74,5,69,38,19,19,37,21,5,1,10
2020-04-29,CIRACAS,100,3,97,38,12,26,38,18,3,5,12
2020-04-29,DUREN SAWIT,97,1,96,44,26,18,133,67,10,22,34
2020-04-29,GAMBIR,90,5,85,30,17,13,31,11,3,6,11
2020-04-29,GROGOL PETAMBURAN,102,2,100,39,13,26,92,39,24,10,19
2020-04-29,JAGAKARSA,60,0,60,44,10,34,62,28,7,4,23
2020-04-29,JATINEGARA,43,4,39,21,9,12,70,35,1,9,25
2020-04-29,JOHAR BARU,113,1,112,34,15,19,37,11,6,6,14
2020-04-29,KALI DERES,66,2,64,43,11,32,90,33,23,9,25
2020-04-29,KEBAYORAN BARU,59,4,55,52,30,22,56,20,26,3,7
2020-04-29,KEBAYORAN LAMA,70,2,68,40,19,21,83,34,12,15,22
2020-04-29,KEBON JERUK,118,2,116,60,19,41,106,45,18,9,34
2020-04-29,KELAPA GADING,198,2,196,76,19,57,85,31,16,7,31
2020-04-29,KEMAYORAN,167,8,159,74,36,38,66,20,5,12,29
2020-04-29,KEMBANGAN,50,3,47,39,17,22,67,26,16,4,21
2020-04-29,KEP. SERIBU SELATAN,36,1,35,4,0,4,9,0,0,0,9
2020-04-29,KEP. SERIBU UTARA,102,2,100,12,1,11,1,0,0,0,1
2020-04-29,KOJA,140,8,132,57,20,37,55,27,3,2,23
2020-04-29,KRAMAT JATI,54,2,52,33,15,18,70,24,5,7,34
2020-04-29,LUAR DKI JAKARTA,1333,24,1309,907,117,790,736,408,62,53,213
2020-04-29,MAKASAR,36,3,33,22,5,17,47,23,9,6,9
2020-04-29,MAMPANG PRAPATAN,90,1,89,25,12,13,36,12,6,6,12
2020-04-29,MATRAMAN,125,7,118,61,22,39,74,37,4,7,26
2020-04-29,MENTENG,57,0,57,23,10,13,51,25,4,8,14
2020-04-29,PADEMANGAN,93,4,89,29,9,20,71,21,4,6,40
2020-04-29,PALMERAH,71,3,68,35,16,19,66,28,9,5,24
2020-04-29,PANCORAN,40,1,39,27,8,19,40,24,4,3,9
2020-04-29,PASAR MINGGU,143,7,136,53,18,35,78,34,11,12,21
2020-04-29,PASAR REBO,33,6,27,25,10,15,31,10,3,4,14
2020-04-29,PENJARINGAN,103,3,100,52,9,43,66,40,5,7,14
2020-04-29,PESANGGRAHAN,42,1,41,30,9,21,63,27,9,14,13
2020-04-29,PULO GADUNG,133,6,127,69,29,40,92,49,7,9,27
2020-04-29,SAWAH BESAR,126,7,119,52,17,35,52,31,3,6,12
2020-04-29,SENEN,93,2,91,41,19,22,55,25,3,3,24
2020-04-29,SETIA BUDI,63,1,62,36,7,29,46,24,8,6,8
2020-04-29,TAMAN SARI,60,1,59,30,12,18,58,47,0,4,7
2020-04-29,TAMBORA,37,2,35,21,12,9,27,16,2,3,6
2020-04-29,TANAH ABANG,133,7,126,82,35,47,196,49,6,11,130
2020-04-29,TANJUNG PRIOK,169,12,157,103,46,57,135,70,8,15,42
2020-04-29,TEBET,53,1,52,44,14,30,91,39,12,11,29
2020-04-30,BELUM DIKETAHUI,2649,49,2600,2751,149,2602,405,328,15,7,55
2020-04-30,CAKUNG,161,3,158,64,27,37,78,35,10,9,24
2020-04-30,CEMPAKA PUTIH,165,2,163,60,12,48,74,33,5,7,29
2020-04-30,CENGKARENG,58,2,56,30,7,23,72,39,7,7,19
2020-04-30,CILANDAK,87,5,82,60,11,49,74,30,12,14,18
2020-04-30,CILINCING,204,4,200,43,20,23,42,22,0,4,16
2020-04-30,CIPAYUNG,75,5,70,39,20,19,38,22,5,1,10
2020-04-30,CIRACAS,107,3,104,42,14,28,39,18,3,5,13
2020-04-30,DUREN SAWIT,98,1,97,44,26,18,135,68,10,22,35
2020-04-30,GAMBIR,90,5,85,30,17,13,34,13,3,6,12
2020-04-30,GROGOL PETAMBURAN,102,2,100,39,13,26,97,41,25,11,20
2020-04-30,JAGAKARSA,63,0,63,44,10,34,65,30,7,4,24
2020-04-30,JATINEGARA,46,4,42,25,9,16,72,36,1,9,26
2020-04-30,JOHAR BARU,114,1,113,35,15,20,37,11,6,6,14
2020-04-30,KALI DERES,67,2,65,44,12,32,95,34,23,9,29
2020-04-30,KEBAYORAN BARU,60,4,56,53,31,22,58,21,26,3,8
2020-04-30,KEBAYORAN LAMA,70,2,68,41,20,21,83,34,12,15,22
2020-04-30,KEBON JERUK,124,2,122,60,19,41,113,50,18,9,36
2020-04-30,KELAPA GADING,207,1,206,76,19,57,88,33,16,7,32
2020-04-30,KEMAYORAN,170,8,162,74,36,38,70,21,5,12,32
2020-04-30,KEMBANGAN,50,3,47,39,17,22,70,26,16,4,24
2020-04-30,KEP. SERIBU SELATAN,36,1,35,4,0,4,9,0,0,0,9
2020-04-30,KEP. SERIBU UTARA,102,2,100,12,1,11,1,0,0,0,1
2020-04-30,KOJA,145,8,137,57,20,37,55,27,3,2,23
2020-04-30,KRAMAT JATI,55,2,53,33,15,18,71,25,5,7,34
2020-04-30,LUAR DKI JAKARTA,1336,22,1314,908,118,790,754,422,62,54,216
2020-04-30,MAKASAR,37,2,35,23,5,18,48,24,9,6,9
2020-04-30,MAMPANG PRAPATAN,93,1,92,25,12,13,36,12,6,6,12
2020-04-30,MATRAMAN,130,7,123,65,23,42,74,37,4,7,26
2020-04-30,MENTENG,57,0,57,23,10,13,51,25,4,8,14
2020-04-30,PADEMANGAN,100,4,96,30,9,21,73,23,4,6,40
2020-04-30,PALMERAH,73,3,70,35,16,19,69,31,9,5,24
2020-04-30,PANCORAN,41,1,40,27,8,19,40,24,4,3,9
2020-04-30,PASAR MINGGU,150,5,145,53,18,35,80,36,11,12,21
2020-04-30,PASAR REBO,34,6,28,25,10,15,30,10,3,4,13
2020-04-30,PENJARINGAN,104,3,101,52,9,43,70,40,5,7,18
2020-04-30,PESANGGRAHAN,43,1,42,31,9,22,63,26,9,14,14
2020-04-30,PULO GADUNG,142,6,136,72,30,42,94,51,7,9,27
2020-04-30,SAWAH BESAR,126,7,119,52,17,35,54,33,3,6,12
2020-04-30,SENEN,100,2,98,41,19,22,57,25,3,3,26
2020-04-30,SETIA BUDI,67,1,66,37,7,30,48,26,8,6,8
2020-04-30,TAMAN SARI,60,1,59,31,13,18,62,48,0,4,10
2020-04-30,TAMBORA,38,2,36,21,12,9,29,17,2,4,6
2020-04-30,TANAH ABANG,179,7,172,82,35,47,204,56,6,11,131
2020-04-30,TANJUNG PRIOK,174,12,162,104,47,57,136,71,8,15,42
2020-04-30,TEBET,57,1,56,46,15,31,91,39,12,11,29
